Sneathia sp.	Fusobacteria	negative
Desulfovibrio fructosovorans	Deltaproteobacteria	negative
Arthrospira sp.	Cyanobacteria	negative
Nitrococcus mobilis	Gammaproteobacteria	negative
Helicobacter felis	Epsilonproteobacteria	negative
Mycobacterium colombiense	Actinobacteria	positive
Haemophilus haemolyticus	Gammaproteobacteria	negative
Xanthomonas campestris	Gammaproteobacteria	negative
Pseudoxanthomonas suwonensis	Gammaproteobacteria	negative
Coprococcus catus	Firmicutes	positive
Xylanimonas cellulosilytica	Actinobacteria	positive
Acidimicrobium ferrooxidans	Actinobacteria	positive
Rhodothermus marinus	Bacteroidetes/Chlorobi	negative
Marinitoga piezophila	Thermotogae	negative
Megasphaera sp.	Firmicutes	negative
Mycobacterium kansasii	Actinobacteria	positive
Actinomyces urogenitalis	Actinobacteria	positive
Oscillochloris trichoides	Chloroflexi	negative
Carboxydibrachium pacificum	Firmicutes	positive
Marinobacter adhaerens	Gammaproteobacteria	negative
unidentified eubacterium	Bacteroidetes/Chlorobi	negative
Ketogulonigenium vulgarum	Alphaproteobacteria	negative
Moraxella bovoculi	Gammaproteobacteria	negative
Leptospira licerasiae	Spirochaetes	negative
Chryseobacterium gleum	Bacteroidetes/Chlorobi	negative
Mesoplasma florum	Firmicutes	positive
Ruminococcaceae bacterium	Firmicutes	positive
Roseburia inulinivorans	Firmicutes	positive
Exiguobacterium sibiricum	Firmicutes	positive
Roseobacter denitrificans	Alphaproteobacteria	negative
Thermotoga naphthophila	Thermotogae	negative
Anaerococcus lactolyticus	Firmicutes	positive
Campylobacter lanienae	Epsilonproteobacteria	negative
Bordetella pertussis	Betaproteobacteria	negative
Halothiobacillus neapolitanus	Gammaproteobacteria	negative
Haliscomenobacter hydrossis	Bacteroidetes/Chlorobi	negative
Streptomyces ipomoeae	Actinobacteria	positive
Thiocystis violascens	Gammaproteobacteria	negative
Helicobacter salomonis	Epsilonproteobacteria	negative
Mycobacterium intracellulare	Actinobacteria	positive
Aeromicrobium marinum	Actinobacteria	positive
Brachybacterium faecium	Actinobacteria	positive
Bifidobacterium catenulatum	Actinobacteria	positive
Halobacteroides halobius	Firmicutes	negative
Bergeyella zoohelcum	Bacteroidetes/Chlorobi	negative
Brachybacterium paraconglomeratum	Actinobacteria	positive
Myxococcus fulvus	Deltaproteobacteria	negative
Pontibacter actiniarum	Bacteroidetes/Chlorobi	negative
Thiomonas intermedia	Betaproteobacteria	negative
Citromicrobium sp.	Alphaproteobacteria	negative
Gordonia bronchialis	Actinobacteria	positive
Rhizobium etli	Alphaproteobacteria	negative
Sphingobacterium sp.	Bacteroidetes/Chlorobi	negative
Rickettsia slovaca	Alphaproteobacteria	negative
Lyngbya majuscula	Cyanobacteria	negative
Parabacteroides sp.	Bacteroidetes/Chlorobi	negative
Rahnella sp.	Gammaproteobacteria	negative
Sphingomonas elodea	Alphaproteobacteria	negative
Pseudoramibacter alactolyticus	Firmicutes	positive
Caldicellulosiruptor hydrothermalis	Firmicutes	positive
Brevibacterium sp.	Actinobacteria	positive
Sulfobacillus acidophilus	Firmicutes	positive
Mycobacterium bovis	Actinobacteria	positive
Burkholderia ubonensis	Betaproteobacteria	negative
Filifactor alocis	Firmicutes	positive
Bordetella avium	Betaproteobacteria	negative
Cellvibrio gilvus	Gammaproteobacteria	negative
Caldicellulosiruptor lactoaceticus	Firmicutes	positive
Brucella pinnipedialis	Alphaproteobacteria	negative
alpha proteobacterium	Alphaproteobacteria	negative
Acidovorax radicis	Betaproteobacteria	negative
Enterococcus mundtii	Firmicutes	positive
Thiomonas sp.	Betaproteobacteria	negative
Thermoanaerobacterium xylanolyticum	Firmicutes	positive
Labrenzia alexandrii	Alphaproteobacteria	negative
Mycoplasma pneumoniae	Firmicutes	negative
Corynebacterium glucuronolyticum	Actinobacteria	positive
Xanthomonas oryzae	Gammaproteobacteria	negative
Crocosphaera watsonii	Cyanobacteria	negative
Weissella paramesenteroides	Firmicutes	positive
Rhodoferax sp.	Betaproteobacteria	negative
Bacillus cellulosilyticus	Firmicutes	positive
Campylobacter lari	Epsilonproteobacteria	negative
Muricauda ruestringensis	Bacteroidetes/Chlorobi	negative
Prevotella ruminicola	Bacteroidetes/Chlorobi	negative
Calothrix rhizosoleniae	Cyanobacteria	negative
Enterobacter cancerogenus	Gammaproteobacteria	negative
Cytophaga hutchinsonii	Bacteroidetes/Chlorobi	negative
Eubacterium ventriosum	Firmicutes	positive
Arthrobacter aurescens	Actinobacteria	positive
Neisseria sicca	Betaproteobacteria	negative
Enterobacter aerogenes	Gammaproteobacteria	negative
Vibrio harveyi	Gammaproteobacteria	negative
Pseudomonas fulva	Gammaproteobacteria	negative
Mycobacterium tusciae	Actinobacteria	positive
Campylobacter cuniculorum	Epsilonproteobacteria	negative
Streptococcus pseudopneumoniae	Firmicutes	positive
Lactobacillus ruminis	Firmicutes	positive
Actinospica robiniae	Actinobacteria	positive
Aerococcus sp.	Firmicutes	positive
Owenweeksia hongkongensis	Bacteroidetes/Chlorobi	negative
Caldalkalibacillus thermarum	Firmicutes	positive
Serratia	Gammaproteobacteria	negative
Proteus penneri	Gammaproteobacteria	negative
Lactobacillus sp.	Firmicutes	positive
Bacteroides clarus	Bacteroidetes/Chlorobi	negative
Atopobium parvulum	Actinobacteria	positive
Novosphingobium sp.	Alphaproteobacteria	negative
Alistipes putredinis	Bacteroidetes/Chlorobi	negative
Spiroplasma kunkelii	Tenericutes	positive
Lactobacillus oris	Firmicutes	positive
Brevibacterium linens	Actinobacteria	positive
Caldicellulosiruptor obsidiansis	Firmicutes	positive
Streptomyces roseosporus	Actinobacteria	positive
Aggregatibacter segnis	Gammaproteobacteria	negative
Photobacterium damselae	Gammaproteobacteria	negative
Acaryochloris marina	Cyanobacteria	negative
Burkholderia mallei	Betaproteobacteria	negative
Herbaspirillum frisingense	Betaproteobacteria	negative
Granulicatella sp.	Firmicutes	positive
Kytococcus sedentarius	Actinobacteria	positive
Streptomyces ambofaciens	Actinobacteria	positive
Marinobacterium stanieri	Gammaproteobacteria	negative
Citricoccus sp.	Actinobacteria	positive
Mycobacterium microti	Actinobacteria	positive
Clostridium sticklandii	Firmicutes	positive
Thermomonospora curvata	Actinobacteria	positive
Leptothrix cholodnii	Betaproteobacteria	negative
Rhodococcus jostii	Actinobacteria	positive
Turicibacter sanguinis	Firmicutes	positive
Gloeothece sp.	Cyanobacteria	negative
Providencia rustigianii	Gammaproteobacteria	negative
Dechloromonas aromatica	Betaproteobacteria	negative
Campylobacter ureolyticus	Epsilonproteobacteria	negative
Thermodesulfobium narugense	Firmicutes	negative
Desulfotomaculum acetoxidans	Firmicutes	positive
Coriobacteriaceae bacterium	Actinobacteria	positive
Neisseria lactamica	Betaproteobacteria	negative
Polaromonas sp.	Betaproteobacteria	negative
Streptococcus ictaluri	Firmicutes	positive
Bacteroides uniformis	Bacteroidetes/Chlorobi	negative
Citrobacter sp.	Gammaproteobacteria	negative
Azotobacter vinelandii	Gammaproteobacteria	negative
Vibrio tubiashii	Gammaproteobacteria	negative
Lactobacillus crispatus	Firmicutes	positive
Hoeflea phototrophica	Alphaproteobacteria	negative
Campylobacter concisus	Epsilonproteobacteria	negative
Clostridium tetani	Firmicutes	positive
Clostridium spiroforme	Firmicutes	positive
Streptomyces clavuligerus	Actinobacteria	positive
Pirellula staleyi	Planctomycetes	negative
Limnobacter sp.	Betaproteobacteria	negative
Planctomyces brasiliensis	Planctomycetes	negative
Citrobacter youngae	Gammaproteobacteria	negative
Campylobacter coli	Epsilonproteobacteria	negative
Pasteuria nishizawae	Firmicutes	positive
Arthrospira maxima	Cyanobacteria	negative
Marichromatium purpuratum	Gammaproteobacteria	negative
Pasteurella multocida	Gammaproteobacteria	negative
Bifidobacterium bifidum	Actinobacteria	positive
Eubacterium infirmum	Firmicutes	positive
Neptuniibacter caesariensis	Gammaproteobacteria	negative
Acetivibrio cellulolyticus	Firmicutes	negative
Acinetobacter baumannii	Gammaproteobacteria	negative
Borrelia burgdorferi	Spirochaetes	negative
Aerococcus urinae	Firmicutes	positive
Mycobacterium avium	Actinobacteria	positive
Mycoplasma mycoides	Firmicutes	negative
Neisseria macacae	Betaproteobacteria	negative
Mycoplasma penetrans	Firmicutes	negative
Oceanospirillales bacterium	Gammaproteobacteria	negative
Taylorella equigenitalis	Betaproteobacteria	negative
Sulfobacillus thermosulfidooxidans	Firmicutes	positive
Lactobacillus delbrueckii	Firmicutes	positive
Dialister microaerophilus	Firmicutes	negative
Nocardia farcinica	Actinobacteria	positive
Streptococcus infantis	Firmicutes	positive
Shewanella benthica	Gammaproteobacteria	negative
Arcobacter thereius	Epsilonproteobacteria	negative
Lactobacillus fructivorans	Firmicutes	positive
Nitrosococcus oceani	Gammaproteobacteria	negative
Thioploca araucae	Gammaproteobacteria	negative
Lactobacillus sanfranciscensis	Firmicutes	positive
Saccharomonospora paurometabolica	Actinobacteria	positive
Vibrio scophthalmi	Gammaproteobacteria	negative
Magnetospirillum sp.	Alphaproteobacteria	negative
Ectothiorhodospira haloalkaliphila	Gammaproteobacteria	negative
Nitrosomonas sp.	Betaproteobacteria	negative
BEV proteobacterium	Gammaproteobacteria	negative
Ralstonia pickettii	Betaproteobacteria	negative
Brucella canis	Alphaproteobacteria	negative
Desulfosporosinus meridiei	Firmicutes	positive
Riemerella anatipestifer	Bacteroidetes/Chlorobi	negative
Mycoplasma alligatoris	Firmicutes	negative
Microcoleus chthonoplastes	Cyanobacteria	negative
Brachyspira intermedia	Spirochaetes	negative
Mycoplasma haemofelis	Firmicutes	negative
Thermosynechococcus elongatus	Cyanobacteria	negative
Pseudomonas viridiflava	Gammaproteobacteria	negative
Burkholderia cenocepacia	Betaproteobacteria	negative
Helicobacter bizzozeronii	Epsilonproteobacteria	negative
Saccharomonospora cyanea	Actinobacteria	positive
Lactobacillus catenaformis	Firmicutes	positive
Exiguobacterium sp.	Firmicutes	positive
Burkholderia oklahomensis	Betaproteobacteria	negative
Desulfosporosinus acidiphilus	Firmicutes	positive
Lentibacillus sp.	Firmicutes	positive
Enterobacter cloacae	Gammaproteobacteria	negative
Corynebacterium lipophiloflavum	Actinobacteria	positive
delta proteobacterium	Deltaproteobacteria	negative
Halobacillus halophilus	Firmicutes	negative
Afipia sp.	Alphaproteobacteria	negative
Borrelia valaisiana	Spirochaetes	negative
Bacteroides sp.	Bacteroidetes/Chlorobi	negative
Porphyromonas uenonis	Bacteroidetes/Chlorobi	negative
Mycobacterium africanum	Actinobacteria	positive
Streptococcus urinalis	Firmicutes	positive
Flavobacterium psychrophilum	Bacteroidetes/Chlorobi	negative
Bacteroides nordii	Bacteroidetes/Chlorobi	negative
Kitasatospora setae	Actinobacteria	positive
Streptococcus peroris	Firmicutes	positive
Burkholderia glathei	Betaproteobacteria	negative
Cellulomonas flavigena	Actinobacteria	positive
Leptothrix ochracea	Betaproteobacteria	negative
Bacteroides eggerthii	Bacteroidetes/Chlorobi	negative
Methylobacterium sp.	Alphaproteobacteria	negative
Staphylococcus lugdunensis	Firmicutes	positive
Bacteroides coprophilus	Bacteroidetes/Chlorobi	negative
Actinobacillus suis	Gammaproteobacteria	negative
Acidovorax citrulli	Betaproteobacteria	negative
Allochromatium vinosum	Gammaproteobacteria	negative
Marinomonas mediterranea	Gammaproteobacteria	negative
Kribbella flavida	Actinobacteria	positive
Lawsonia intracellularis	Deltaproteobacteria	negative
Leeuwenhoekiella blandensis	Bacteroidetes/Chlorobi	negative
Actinobacillus ureae	Gammaproteobacteria	negative
Lactobacillus coryniformis	Firmicutes	positive
Flectobacillus major	Bacteroidetes/Chlorobi	negative
Helicobacter canadensis	Epsilonproteobacteria	negative
Selenomonas ruminantium	Firmicutes	negative
Sulfurihydrogenibium sp.	Aquificae	negative
Streptomyces sp.	Actinobacteria	positive
Prevotella amnii	Bacteroidetes/Chlorobi	negative
Niastella koreensis	Bacteroidetes/Chlorobi	negative
Kingella denitrificans	Betaproteobacteria	negative
Alcanivorax dieselolei	Gammaproteobacteria	negative
Moritella sp.	Gammaproteobacteria	negative
Oceanicola batsensis	Alphaproteobacteria	negative
Dorea longicatena	Firmicutes	positive
Thiorhodococcus drewsii	Gammaproteobacteria	negative
Veillonella parvula	Firmicutes	negative
Bacteroidetes oral	Bacteroidetes/Chlorobi	negative
Avibacterium paragallinarum	Gammaproteobacteria	negative
Pusillimonas sp.	Betaproteobacteria	negative
Roseburia intestinalis	Firmicutes	positive
Brucella suis	Alphaproteobacteria	negative
Alistipes indistinctus	Bacteroidetes/Chlorobi	negative
Lutiella nitroferrum	Betaproteobacteria	negative
Burkholderia sp.	Betaproteobacteria	negative
Marivirga tractuosa	Bacteroidetes/Chlorobi	negative
Eubacterium eligens	Firmicutes	positive
cyanobacterium UCYN-A	Cyanobacteria	negative
Silicibacter lacuscaerulensis	Alphaproteobacteria	negative
Corynebacterium genitalium	Actinobacteria	positive
Lactobacillus animalis	Firmicutes	positive
Bacillus anthracis	Firmicutes	positive
Actinomyces oris	Actinobacteria	positive
Planctomyces maris	Planctomycetes	negative
Burkholderia seminalis	Betaproteobacteria	negative
Bacillus selenitireducens	Firmicutes	positive
Mycobacterium canettii	Actinobacteria	positive
Weissella thailandensis	Firmicutes	positive
Chlamydia muridarum	Chlamydiae/Verrucomicrobia	negative
Acetobacteraceae bacterium	Alphaproteobacteria	negative
Rickettsia massiliae	Alphaproteobacteria	negative
Neisseria mucosa	Betaproteobacteria	negative
Roseburia hominis	Firmicutes	positive
Thermotoga lettingae	Thermotogae	negative
Starkeya novella	Alphaproteobacteria	negative
Helicobacter cinaedi	Epsilonproteobacteria	negative
Thermotogales bacterium	Thermotogae	negative
Rikenella microfusus	Bacteroidetes/Chlorobi	negative
Acetobacterium woodii	Firmicutes	positive
Shewanella violacea	Gammaproteobacteria	negative
Acidovorax ebreus	Betaproteobacteria	negative
Cellvibrio japonicus	Gammaproteobacteria	negative
Campylobacter insulaenigrae	Epsilonproteobacteria	negative
Burkholderia phytofirmans	Betaproteobacteria	negative
Chromobacterium violaceum	Betaproteobacteria	negative
Acinetobacter calcoaceticus	Gammaproteobacteria	negative
Methylobacter tundripaludum	Gammaproteobacteria	negative
Salmonella enterica	Gammaproteobacteria	negative
Bermanella marisrubri	Gammaproteobacteria	negative
Campylobacter gracilis	Epsilonproteobacteria	negative
Desulfobacula toluolica	Deltaproteobacteria	negative
Campylobacter avium	Epsilonproteobacteria	negative
Ruminococcus sp.	Firmicutes	positive
Rhodobacter sphaeroides	Alphaproteobacteria	negative
Parabacteroides distasonis	Bacteroidetes/Chlorobi	negative
Nocardioides sp.	Actinobacteria	positive
Brenneria sp.	Gammaproteobacteria	negative
Pseudoflavonifractor capillosus	Bacteroidetes/Chlorobi	negative
Leuconostoc fallax	Firmicutes	positive
Mycobacterium rhodesiae	Actinobacteria	positive
Burkholderia vietnamiensis	Betaproteobacteria	negative
actinobacterium SCGC	Actinobacteria	positive
Corynebacterium nuruki	Actinobacteria	positive
Borrelia sp.	Spirochaetes	negative
Mycoplasma capricolum	Firmicutes	negative
Chloroflexus aurantiacus	Chloroflexi	negative
Eubacterium biforme	Firmicutes	positive
Alistipes sp.	Bacteroidetes/Chlorobi	negative
Ewingella americana	Gammaproteobacteria	negative
Desulfotomaculum nigrificans	Firmicutes	positive
Ralstonia eutropha	Betaproteobacteria	negative
Pantoea sp.	Gammaproteobacteria	negative
Lyngbya sp.	Cyanobacteria	negative
Thermoanaerobacter sp.	Firmicutes	positive
Parvimonas micra	Firmicutes	positive
Gramella forsetii	Bacteroidetes/Chlorobi	negative
Pediococcus acidilactici	Firmicutes	positive
Geothrix fermentans	Acidobacteria	negative
Lactobacillus acidophilus	Firmicutes	positive
Peptococcus sp.	Firmicutes	positive
Clostridium thermocellum	Firmicutes	positive
Sphaerobacter thermophilus	Chloroflexi	negative
Mycobacterium tuberculosis	Actinobacteria	positive
Eubacterium cellulosolvens	Firmicutes	positive
Streptococcus suis	Firmicutes	positive
Agrobacterium vitis	Alphaproteobacteria	negative
Paracoccus denitrificans	Alphaproteobacteria	negative
Agrobacterium sp.	Alphaproteobacteria	negative
Spiroplasma eriocheiris	Tenericutes	positive
Oribacterium sp.	Firmicutes	positive
Magnetospirillum gryphiswaldense	Alphaproteobacteria	negative
Rivularia sp.	Cyanobacteria	negative
Yersinia mollaretii	Gammaproteobacteria	negative
Haemophilus [parainfluenzae]	Gammaproteobacteria	negative
Megamonas funiformis	Firmicutes	negative
Deinococcus peraridilitoris	Deinococcus-Thermus	negative
Petrotoga mobilis	Thermotogae	negative
Methylobacterium nodulans	Alphaproteobacteria	negative
Acidaminococcus intestinalis	Firmicutes	negative
Acidiphilium multivorum	Alphaproteobacteria	negative
Burkholderia tuberum	Betaproteobacteria	negative
Zobellia galactanivorans	Bacteroidetes/Chlorobi	negative
Azoarcus sp.	Betaproteobacteria	negative
Ruminococcus bromii	Firmicutes	positive
Desmospora sp.	Firmicutes	positive
Desulfitobacterium dehalogenans	Firmicutes	positive
Lactobacillus salivarius	Firmicutes	positive
Actinomyces turicensis	Actinobacteria	positive
Thermotoga sp.	Thermotogae	negative
Geobacter lovleyi	Deltaproteobacteria	negative
Oceanithermus profundus	Deinococcus-Thermus	negative
Methylobacterium extorquens	Alphaproteobacteria	negative
Comamonadaceae bacterium	Betaproteobacteria	negative
Streptomyces viridosporus	Actinobacteria	positive
Enterococcus faecium	Firmicutes	positive
Propionibacterium acnes	Actinobacteria	positive
Lactobacillus plantarum	Firmicutes	positive
Leuconostoc mesenteroides	Firmicutes	positive
Staphylococcus xylosus	Firmicutes	positive
Ignavibacterium album	Bacteroidetes/Chlorobi	negative
Lactobacillus parafarraginis	Firmicutes	positive
Mycobacterium indicus	Actinobacteria	positive
Bacillus coahuilensis	Firmicutes	positive
Saccharophagus degradans	Gammaproteobacteria	negative
Syntrophorhabdus aromaticivorans	Deltaproteobacteria	negative
Streptococcus sanguinis	Firmicutes	positive
Leifsonia xyli	Actinobacteria	positive
Pelobacter propionicus	Deltaproteobacteria	negative
Aquifex aeolicus	Aquificae	negative
Acetobacter pasteurianus	Alphaproteobacteria	negative
Rhodospirillum centenum	Alphaproteobacteria	negative
Corynebacterium sp.	Actinobacteria	positive
Nitrosococcus watsonii	Gammaproteobacteria	negative
Yersinia bercovieri	Gammaproteobacteria	negative
Thermotoga neapolitana	Thermotogae	negative
Bacillus vallismortis	Firmicutes	positive
Veillonella ratti	Firmicutes	negative
Lactobacillus vaginalis	Firmicutes	positive
Micromonospora aurantiaca	Actinobacteria	positive
Paraprevotella clara	Bacteroidetes/Chlorobi	negative
Methylobacterium radiotolerans	Alphaproteobacteria	negative
Lysinibacillus fusiformis	Firmicutes	positive
Nitrospina gracilis	Deltaproteobacteria	negative
Pseudonocardia dioxanivorans	Actinobacteria	positive
Bacteroides dorei	Bacteroidetes/Chlorobi	negative
Peptostreptococcus sp.	Firmicutes	positive
Chlamydophila abortus	Chlamydiae/Verrucomicrobia	negative
Flavobacteriaceae bacterium	Bacteroidetes/Chlorobi	negative
Sulfurimonas sp.	Epsilonproteobacteria	negative
Propionibacterium avidum	Actinobacteria	positive
Campylobacter hyointestinalis	Epsilonproteobacteria	negative
Borrelia garinii	Spirochaetes	negative
Isosphaera pallida	Planctomycetes	negative
Turicella otitidis	Actinobacteria	positive
Pedobacter heparinus	Bacteroidetes/Chlorobi	negative
Xanthomonas perforans	Gammaproteobacteria	negative
Campylobacter fetus	Epsilonproteobacteria	negative
Burkholderia silvatlantica	Betaproteobacteria	negative
Porphyromonas gingivalis	Bacteroidetes/Chlorobi	negative
Clostridium symbiosum	Firmicutes	positive
Brevibacterium mcbrellneri	Actinobacteria	positive
Mitsuokella multacida	Firmicutes	negative
Clostridium aldenense	Firmicutes	positive
Lacinutrix sp.	Bacteroidetes/Chlorobi	negative
Corynebacterium urealyticum	Actinobacteria	positive
Lactobacillus versmoldensis	Firmicutes	positive
Edwardsiella ictaluri	Gammaproteobacteria	negative
Burkholderiales bacterium	Betaproteobacteria	negative
Thermosipho melanesiensis	Thermotogae	negative
Aliivibrio salmonicida	Gammaproteobacteria	negative
Brachyspira hyodysenteriae	Spirochaetes	negative
Tetrathiobacter kashmirensis	Betaproteobacteria	negative
Treponema azotonutricium	Spirochaetes	negative
Turneriella parva	Spirochaetes	negative
Prevotella copri	Bacteroidetes/Chlorobi	negative
Oxalobacter formigenes	Betaproteobacteria	negative
Propionibacterium humerusii	Actinobacteria	positive
Lysinibacillus sphaericus	Firmicutes	positive
Corynebacterium striatum	Actinobacteria	positive
Nitrosomonas europaea	Betaproteobacteria	negative
Pseudomonas pseudoalcaligenes	Gammaproteobacteria	negative
Papillibacter sp.	Firmicutes	positive
Patulibacter minatonensis	Actinobacteria	positive
Bartonella schoenbuchensis	Alphaproteobacteria	negative
Prochlorococcus sp.	Cyanobacteria	negative
Trichodesmium erythraeum	Cyanobacteria	negative
Mobiluncus curtisii	Actinobacteria	positive
Actinoplanes missouriensis	Actinobacteria	positive
Anaerococcus sp.	Firmicutes	positive
Chlorobium tepidum	Bacteroidetes/Chlorobi	negative
Chlorobium chlorochromatii	Bacteroidetes/Chlorobi	negative
Halothece sp.	Cyanobacteria	negative
Gluconacetobacter sp.	Alphaproteobacteria	negative
Clostridium hiranonis	Firmicutes	positive
Oceanicola sp.	Alphaproteobacteria	negative
Odoribacter splanchnicus	Bacteroidetes/Chlorobi	negative
Pseudovibrio sp.	Alphaproteobacteria	negative
Methylophaga thalassica	Gammaproteobacteria	negative
Alkalilimnicola ehrlichii	Gammaproteobacteria	negative
Methylocystis sp.	Alphaproteobacteria	negative
Succinivibrionaceae bacterium	Gammaproteobacteria	negative
Peptoniphilus harei	Firmicutes	positive
Ureaplasma parvum	Firmicutes	negative
Mycobacterium massiliense	Actinobacteria	positive
Veillonella sp.	Firmicutes	negative
Pseudomonas entomophila	Gammaproteobacteria	negative
Eubacterium minutum	Firmicutes	positive
Leptospira santarosai	Spirochaetes	negative
Methylibium petroleiphilum	Betaproteobacteria	negative
Citrobacter freundii	Gammaproteobacteria	negative
Simonsiella muelleri	Betaproteobacteria	negative
Cryptosporangium arvum	Actinobacteria	positive
Eubacterium rectale	Firmicutes	positive
Salinispora arenicola	Actinobacteria	positive
Paenibacillus larvae	Firmicutes	positive
Granulicatella elegans	Firmicutes	positive
Finegoldia magna	Firmicutes	positive
Kordia algicida	Bacteroidetes/Chlorobi	negative
Dietzia cinnamea	Actinobacteria	positive
Heliobacterium modesticaldum	Firmicutes	negative
Lactobacillus paracasei	Firmicutes	positive
Microbacterium testaceum	Actinobacteria	positive
Streptococcus infantarius	Firmicutes	positive
Thermus scotoductus	Deinococcus-Thermus	negative
Rhizobium endophyticum	Alphaproteobacteria	negative
Streptococcus macacae	Firmicutes	positive
Streptomyces himastatinicus	Actinobacteria	positive
Halanaerobium praevalens	Firmicutes	positive
Kingella sp.	Betaproteobacteria	negative
Gordonia sp.	Actinobacteria	positive
Macrococcus caseolyticus	Firmicutes	positive
Geodermatophilus obscurus	Actinobacteria	positive
Geobacter metallireducens	Deltaproteobacteria	negative
Thermoanaerobacter mathranii	Firmicutes	positive
Streptomyces cattleya	Actinobacteria	positive
Atopobium rimae	Actinobacteria	positive
Nitrosospira multiformis	Betaproteobacteria	negative
Symbiobacterium thermophilum	Firmicutes	negative
Neisseria flavescens	Betaproteobacteria	negative
Veillonella dispar	Firmicutes	negative
Sporolactobacillus inulinus	Firmicutes	positive
Halomonas elongata	Gammaproteobacteria	negative
Streptomyces violaceusniger	Actinobacteria	positive
Beijerinckia indica	Alphaproteobacteria	negative
Dermocarpa sp.	Cyanobacteria	negative
Actinomyces hongkongensis	Actinobacteria	positive
Francisella philomiragia	Gammaproteobacteria	negative
Xylanibacter oryzae	Bacteroidetes/Chlorobi	negative
Syntrophothermus lipocalidus	Firmicutes	negative
Delftia sp.	Betaproteobacteria	negative
Clostridium sporogenes	Firmicutes	positive
Pseudomonas putida	Gammaproteobacteria	negative
Shewanella frigidimarina	Gammaproteobacteria	negative
Streptococcus pneumoniae	Firmicutes	positive
Simkania negevensis	Chlamydiae/Verrucomicrobia	negative
Colwellia sp.	Gammaproteobacteria	negative
Lachnospiraceae bacterium	Firmicutes	positive
Acinetobacter sp.	Gammaproteobacteria	negative
Bacteriovorax marinus	Deltaproteobacteria	negative
Lactobacillus gasseri	Firmicutes	positive
Campylobacter hominis	Epsilonproteobacteria	negative
Myroides odoratus	Bacteroidetes/Chlorobi	negative
Corynebacterium glutamicum	Actinobacteria	positive
Emticicia oligotrophica	Bacteroidetes/Chlorobi	negative
Salmonella typhimurium	Gammaproteobacteria	negative
Xanthomonas axonopodis	Gammaproteobacteria	negative
Alkaliflexus imshenetskii	Bacteroidetes/Chlorobi	negative
Roseovarius nubinhibens	Alphaproteobacteria	negative
Helcococcus kunzii	Firmicutes	positive
Prosthecochloris aestuarii	Bacteroidetes/Chlorobi	negative
Anaeromyxobacter dehalogenans	Deltaproteobacteria	negative
Carboxydothermus hydrogenoformans	Firmicutes	positive
Klebsiella pneumoniae	Gammaproteobacteria	negative
Acinetobacter genomosp.	Gammaproteobacteria	negative
Congregibacter litoralis	Gammaproteobacteria	negative
Bacteroides galacturonicus	Bacteroidetes/Chlorobi	negative
Rhodococcus pyridinivorans	Actinobacteria	positive
Capnocytophaga canimorsus	Bacteroidetes/Chlorobi	negative
Mycobacterium gilvum	Actinobacteria	positive
Campylobacter rectus	Epsilonproteobacteria	negative
Kingella oralis	Betaproteobacteria	negative
Caldicellulosiruptor bescii	Firmicutes	positive
Streptomyces griseoflavus	Actinobacteria	positive
Selenomonas sp.	Firmicutes	negative
Corynebacterium efficiens	Actinobacteria	positive
Aeromonas caviae	Gammaproteobacteria	negative
Micrococcus luteus	Actinobacteria	positive
Amycolicicoccus subflavus	Actinobacteria	positive
Methylocaldum szegediense	Gammaproteobacteria	negative
Bradyrhizobium sp.	Alphaproteobacteria	negative
Promicromonospora kroppenstedtii	Actinobacteria	positive
Marinitoga camini	Thermotogae	negative
Leptotrichia goodfellowii	Fusobacteria	negative
Streptomyces peucetius	Actinobacteria	positive
Gardnerella vaginalis	Actinobacteria	positive
Facklamia hominis	Firmicutes	positive
Oceanicola granulosus	Alphaproteobacteria	negative
Cyanobium sp.	Cyanobacteria	negative
Prochloron didemni	Cyanobacteria	negative
Beggiatoa alba	Gammaproteobacteria	negative
Collimonas fungivorans	Betaproteobacteria	negative
Corynebacterium diphtheriae	Actinobacteria	positive
Turicibacter sp.	Firmicutes	positive
Saccharomonospora saliphila	Actinobacteria	positive
Streptomyces venezuelae	Actinobacteria	positive
Blastopirellula marina	Planctomycetes	negative
Syntrophobotulus glycolicus	Firmicutes	negative
Shewanella putrefaciens	Gammaproteobacteria	negative
Arcobacter nitrofigilis	Epsilonproteobacteria	negative
Bacteroides xylanisolvens	Bacteroidetes/Chlorobi	negative
Mycoplasma mobile	Firmicutes	negative
Gordonibacter pamelaeae	Actinobacteria	positive
Acidithiobacillus ferrivorans	Gammaproteobacteria	negative
Paraeggerthella hongkongensis	Actinobacteria	positive
Leptotrichia hofstadii	Fusobacteria	negative
Streptococcus dysgalactiae	Firmicutes	positive
Helicobacter hepaticus	Epsilonproteobacteria	negative
Deinococcus geothermalis	Deinococcus-Thermus	negative
Myroides odoratimimus	Bacteroidetes/Chlorobi	negative
Enterococcus italicus	Firmicutes	positive
Terriglobus saanensis	Acidobacteria	negative
Veillonella atypica	Firmicutes	negative
Shuttleworthia satelles	Firmicutes	positive
Centipeda periodontii	Firmicutes	positive
Bartonella sp.	Alphaproteobacteria	negative
Mogibacterium vescum	Firmicutes	positive
Caldicellulosiruptor kronotskyensis	Firmicutes	positive
Rhizobium leguminosarum	Alphaproteobacteria	negative
Enterococcus sp.	Firmicutes	positive
Erwinia tracheiphila	Gammaproteobacteria	negative
Desulfococcus oleovorans	Deltaproteobacteria	negative
Spirochaeta sp.	Spirochaetes	negative
Arcanobacterium haemolyticum	Actinobacteria	positive
Thermoanaerobacter tengcongensis	Firmicutes	positive
Capnocytophaga granulosa	Bacteroidetes/Chlorobi	negative
Herminiimonas arsenicoxydans	Betaproteobacteria	negative
Bacteroides intestinalis	Bacteroidetes/Chlorobi	negative
Staphylococcus aureus	Firmicutes	positive
Leuconostoc lactis	Firmicutes	positive
Bacteroides stercoris	Bacteroidetes/Chlorobi	negative
Oligobacter sp.	Alphaproteobacteria	negative
Serratia symbiotica	Gammaproteobacteria	negative
Thermoanaerobacter brockii	Firmicutes	positive
Frateuria aurantia	Gammaproteobacteria	negative
Gemella sanguinis	Firmicutes	positive
Neorickettsia risticii	Alphaproteobacteria	negative
Lactobacillus antri	Firmicutes	positive
Campylobacter helveticus	Epsilonproteobacteria	negative
Desulfobacterium autotrophicum	Deltaproteobacteria	negative
Nitrobacter winogradskyi	Alphaproteobacteria	negative
Alicycliphilus denitrificans	Betaproteobacteria	negative
Salmonella bongori	Gammaproteobacteria	negative
Leuconostoc argentinum	Firmicutes	positive
Alicyclobacillus acidocaldarius	Firmicutes	positive
Persephonella marina	Aquificae	negative
Photobacterium leiognathi	Gammaproteobacteria	negative
Deinococcus grandis	Deinococcus-Thermus	negative
Vibrio shilonii	Gammaproteobacteria	negative
Mannheimia haemolytica	Gammaproteobacteria	negative
Mycoplasma hyopneumoniae	Firmicutes	negative
Clostridium perfringens	Firmicutes	positive
Pelodictyon phaeoclathratiforme	Bacteroidetes/Chlorobi	negative
Lactobacillus acidipiscis	Firmicutes	positive
Thioalkalimicrobium aerophilum	Gammaproteobacteria	negative
Gillisia limnaea	Bacteroidetes/Chlorobi	negative
Gluconacetobacter europaeus	Alphaproteobacteria	negative
Rhodomicrobium vannielii	Alphaproteobacteria	negative
Brucella sp.	Alphaproteobacteria	negative
Francisella tularensis	Gammaproteobacteria	negative
Staphylococcus hominis	Firmicutes	positive
Streptococcus criceti	Firmicutes	positive
Magnetospirillum magneticum	Alphaproteobacteria	negative
Desulfohalobium retbaense	Deltaproteobacteria	negative
Neisseria sp.	Betaproteobacteria	negative
Thermus thermophilus	Deinococcus-Thermus	negative
Gordonia alkanivorans	Actinobacteria	positive
Listeria innocua	Firmicutes	positive
Campylobacter upsaliensis	Epsilonproteobacteria	negative
Bacillus subtilis	Firmicutes	positive
Arcobacter cryaerophilus	Epsilonproteobacteria	negative
Dichelobacter nodosus	Gammaproteobacteria	negative
Bacteroides ovatus	Bacteroidetes/Chlorobi	negative
Halothermothrix orenii	Firmicutes	negative
Flavobacterium sp.	Bacteroidetes/Chlorobi	negative
Rickettsia felis	Alphaproteobacteria	negative
Eubacterium yurii	Firmicutes	positive
Borrelia recurrentis	Spirochaetes	negative
Methylomicrobium album	Gammaproteobacteria	negative
Bacteroides coprosuis	Bacteroidetes/Chlorobi	negative
Corynebacterium matruchotii	Actinobacteria	positive
Mycoplasma synoviae	Firmicutes	negative
Brevundimonas sp.	Alphaproteobacteria	negative
Leuconostoc gasicomitatum	Firmicutes	positive
Thauera sp.	Betaproteobacteria	negative
Carnobacterium sp.	Firmicutes	positive
Rhodobacterales bacterium	Alphaproteobacteria	negative
Mesorhizobium opportunistum	Alphaproteobacteria	negative
Lactobacillus farciminis	Firmicutes	positive
Rhodococcus equi	Actinobacteria	positive
Rickettsia japonica	Alphaproteobacteria	negative
Hippea maritima	Deltaproteobacteria	negative
Geobacillus kaustophilus	Firmicutes	positive
Maribacter sp.	Bacteroidetes/Chlorobi	negative
Pelagibaca bermudensis	Alphaproteobacteria	negative
Leuconostoc gelidum	Firmicutes	positive
Moraxella bovis	Gammaproteobacteria	negative
Odoribacter laneus	Bacteroidetes/Chlorobi	negative
Ruminococcus torques	Firmicutes	positive
Runella slithyformis	Bacteroidetes/Chlorobi	negative
Burkholderia multivorans	Betaproteobacteria	negative
Treponema vincentii	Spirochaetes	negative
Photorhabdus luminescens	Gammaproteobacteria	negative
Thioalkalivibrio sulfidophilus	Gammaproteobacteria	negative
Cupriavidus necator	Betaproteobacteria	negative
Desulfotalea psychrophila	Deltaproteobacteria	negative
Vibrio parahaemolyticus	Gammaproteobacteria	negative
Marinomonas sp.	Gammaproteobacteria	negative
Oceanobacillus sp.	Firmicutes	positive
Yersinia kristensenii	Gammaproteobacteria	negative
Clostridium asparagiforme	Firmicutes	positive
Bulleidia extructa	Firmicutes	positive
Desulfomicrobium baculatum	Deltaproteobacteria	negative
Corynebacterium pseudotuberculosis	Actinobacteria	positive
Lactobacillus johnsonii	Firmicutes	positive
Paenibacillus vortex	Firmicutes	positive
Herbaspirillum seropedicae	Betaproteobacteria	negative
Fluviicola taffensis	Bacteroidetes/Chlorobi	negative
Bacillus pseudofirmus	Firmicutes	positive
Desulfonema magnum	Deltaproteobacteria	negative
Clostridium orbiscindens	Firmicutes	positive
Shigella flexneri	Gammaproteobacteria	negative
Aeromonas veronii	Gammaproteobacteria	negative
Bacillus sp.	Firmicutes	positive
Desulfitobacterium dichloroeliminans	Firmicutes	positive
Acetohalobium arabaticum	Firmicutes	negative
Rhizobium tropici	Alphaproteobacteria	negative
Alcanivorax borkumensis	Gammaproteobacteria	negative
Kineococcus radiotolerans	Actinobacteria	positive
Desulfomicrobium orale	Deltaproteobacteria	negative
Shewanella sp.	Gammaproteobacteria	negative
Erwinia amylovora	Gammaproteobacteria	negative
Hylemonella gracilis	Betaproteobacteria	negative
Spirochaeta thermophila	Spirochaetes	negative
Amphibacillus xylanus	Firmicutes	positive
Ornithinibacillus sp.	Firmicutes	positive
Spirosoma linguale	Bacteroidetes/Chlorobi	negative
Eremococcus coleocola	Firmicutes	positive
Geobacillus sp.	Firmicutes	positive
Prevotella sp.	Bacteroidetes/Chlorobi	negative
Ralstonia sp.	Betaproteobacteria	negative
Propionibacterium sp.	Actinobacteria	positive
Streptococcus pyogenes	Firmicutes	positive
Hyphomicrobium sp.	Alphaproteobacteria	negative
Cyanothece sp.	Cyanobacteria	negative
Acetonema longum	Firmicutes	negative
Sphingopyxis alaskensis	Alphaproteobacteria	negative
Methylomonas methanica	Gammaproteobacteria	negative
primary endosymbiont	Gammaproteobacteria	negative
Mesorhizobium ciceri	Alphaproteobacteria	negative
Granulicatella para-adiacens	Firmicutes	positive
Erythrobacter sp.	Alphaproteobacteria	negative
Parasutterella excrementihominis	Betaproteobacteria	negative
Olsenella sp.	Actinobacteria	positive
Clostridium propionicum	Firmicutes	positive
Aurantimonas manganoxydans	Alphaproteobacteria	negative
Streptococcus pseudoporcinus	Firmicutes	positive
Alkaliphilus metalliredigens	Firmicutes	positive
Bacteroides caccae	Bacteroidetes/Chlorobi	negative
Pectobacterium atrosepticum	Gammaproteobacteria	negative
Corynebacterium resistens	Actinobacteria	positive
Helicobacter acinonychis	Epsilonproteobacteria	negative
Mycobacterium liflandii	Actinobacteria	positive
Prochlorothrix hollandica	Cyanobacteria	negative
Blattabacterium sp.	Bacteroidetes/Chlorobi	negative
Streptomyces griseoaurantiacus	Actinobacteria	positive
Desulfotomaculum kuznetsovii	Firmicutes	positive
Vibrio sinaloensis	Gammaproteobacteria	negative
Marinobacter sp.	Gammaproteobacteria	negative
Thermus sp.	Deinococcus-Thermus	negative
Lactobacillus kisonensis	Firmicutes	positive
Gallionella capsiferriformans	Betaproteobacteria	negative
Marinobacter aquaeolei	Gammaproteobacteria	negative
Dethiobacter alkaliphilus	Firmicutes	positive
Eikenella corrodens	Betaproteobacteria	negative
Weissella koreensis	Firmicutes	positive
Psychromonas sp.	Gammaproteobacteria	negative
Aequorivita sublithincola	Bacteroidetes/Chlorobi	negative
Solobacterium moorei	Firmicutes	positive
Erwinia tasmaniensis	Gammaproteobacteria	negative
Hafnia alvei	Gammaproteobacteria	negative
Butyrivibrio crossotus	Firmicutes	negative
Pseudomonas tolaasii	Gammaproteobacteria	negative
Thiorhodospira sibirica	Gammaproteobacteria	negative
Streptococcus vestibularis	Firmicutes	positive
Waddlia chondrophila	Chlamydiae/Verrucomicrobia	negative
Erythrobacter litoralis	Alphaproteobacteria	negative
Gemella sp.	Firmicutes	positive
Fusobacterium gonidiaformans	Fusobacteria	negative
Alistipes finegoldii	Bacteroidetes/Chlorobi	negative
Vibrio furnissii	Gammaproteobacteria	negative
Photobacterium sp.	Gammaproteobacteria	negative
Anaerophaga thermohalophila	Bacteroidetes/Chlorobi	negative
Leadbetterella byssophila	Bacteroidetes/Chlorobi	negative
Rickettsia conorii	Alphaproteobacteria	negative
Vibrio cholerae	Gammaproteobacteria	negative
Sinorhizobium fredii	Alphaproteobacteria	negative
Salinibacter ruber	Bacteroidetes/Chlorobi	negative
Phascolarctobacterium sp.	Firmicutes	negative
Solobacterium sp.	Firmicutes	positive
Sulfurospirillum sp.	Epsilonproteobacteria	negative
Chlamydia trachomatis	Chlamydiae/Verrucomicrobia	negative
Burkholderia glumae	Betaproteobacteria	negative
Salinispora tropica	Actinobacteria	positive
Succinatimonas hippei	Gammaproteobacteria	negative
Caldicellulosiruptor kristjanssonii	Firmicutes	positive
Campylobacter sp.	Epsilonproteobacteria	negative
Photobacterium angustum	Gammaproteobacteria	negative
Methylococcus capsulatus	Gammaproteobacteria	negative
Streptomyces turgidiscabies	Actinobacteria	positive
Corynebacterium jeikeium	Actinobacteria	positive
Clostridiaceae bacterium	Firmicutes	positive
Campylobacter mucosalis	Epsilonproteobacteria	negative
Scardovia wiggsiae	Actinobacteria	positive
Methylocella silvestris	Alphaproteobacteria	negative
Serratia odorifera	Gammaproteobacteria	negative
Thermotoga petrophila	Thermotogae	negative
Ruegeria pomeroyi	Alphaproteobacteria	negative
Heliothrix oregonensis	Chloroflexi	negative
Bartonella grahamii	Alphaproteobacteria	negative
Vibrionales bacterium	Gammaproteobacteria	negative
Pectobacterium wasabiae	Gammaproteobacteria	negative
Corynebacterium pseudogenitalium	Actinobacteria	positive
Pseudoalteromonas tunicata	Gammaproteobacteria	negative
Prevotella intermedia	Bacteroidetes/Chlorobi	negative
Thiodictyon sp.	Gammaproteobacteria	negative
Rothia sp.	Actinobacteria	positive
Rhodospirillales bacterium	Alphaproteobacteria	negative
Azospirillum brasilense	Alphaproteobacteria	negative
Vibrio nigripulchritudo	Gammaproteobacteria	negative
Johnsonella ignava	Firmicutes	negative
Eubacterium cylindroides	Firmicutes	positive
Micavibrio aeruginosavorus	Alphaproteobacteria	negative
Mycobacterium leprae	Actinobacteria	positive
Stigmatella aurantiaca	Deltaproteobacteria	negative
Clostridium bartlettii	Firmicutes	positive
Polaromonas naphthalenivorans	Betaproteobacteria	negative
Desulfurobacterium thermolithotrophum	Aquificae	negative
Nostoc sp.	Cyanobacteria	negative
Nodularia spumigena	Cyanobacteria	negative
Loktanella sp.	Alphaproteobacteria	negative
Haemophilus ducreyi	Gammaproteobacteria	negative
Streptococcus cristatus	Firmicutes	positive
Ralstonia solanacearum	Betaproteobacteria	negative
Kutzneria sp.	Actinobacteria	positive
Ornithobacterium rhinotracheale	Bacteroidetes/Chlorobi	negative
Anaplasma phagocytophilum	Alphaproteobacteria	negative
Streptomyces lividans	Actinobacteria	positive
Streptomyces griseus	Actinobacteria	positive
Vibrio ordalii	Gammaproteobacteria	negative
Tsukamurella paurometabola	Actinobacteria	positive
Chlorobium luteolum	Bacteroidetes/Chlorobi	negative
Rhodanobacter sp.	Gammaproteobacteria	negative
Leptotrichia buccalis	Fusobacteria	negative
Methylobacillus flagellatus	Betaproteobacteria	negative
Faecalibacterium cf.	Firmicutes	negative
Prevotella multiformis	Bacteroidetes/Chlorobi	negative
Isoptericola variabilis	Actinobacteria	positive
Aggregatibacter actinomycetemcomitans	Gammaproteobacteria	negative
Vibrio anguillarum	Gammaproteobacteria	negative
Dehalogenimonas lykanthroporepellens	Chloroflexi	negative
Bordetella petrii	Betaproteobacteria	negative
Fulvimarina pelagi	Alphaproteobacteria	negative
Xanthomonas hortorum	Gammaproteobacteria	negative
Treponema phagedenis	Spirochaetes	negative
Arcobacter mytili	Epsilonproteobacteria	negative
Erysipelotrichaceae bacterium	Firmicutes	positive
Ureaplasma urealyticum	Firmicutes	negative
Desulfotomaculum reducens	Firmicutes	positive
Solitalea canadensis	Bacteroidetes/Chlorobi	negative
Vibrio ichthyoenteri	Gammaproteobacteria	negative
Weissella cibaria	Firmicutes	positive
Thermotoga maritima	Thermotogae	negative
Ehrlichia chaffeensis	Alphaproteobacteria	negative
Comamonas testosteroni	Betaproteobacteria	negative
Leuconostoc kimchii	Firmicutes	positive
Shigella dysenteriae	Gammaproteobacteria	negative
Leptospira interrogans	Spirochaetes	negative
Mycoplasma agalactiae	Firmicutes	negative
Variovorax paradoxus	Betaproteobacteria	negative
Methylotenera mobilis	Betaproteobacteria	negative
Thiocapsa marina	Gammaproteobacteria	negative
Pasteurella dagmatis	Gammaproteobacteria	negative
Acidithiobacillus sp.	Gammaproteobacteria	negative
Clostridium methylpentosum	Firmicutes	positive
Teredinibacter turnerae	Gammaproteobacteria	negative
Coprococcus comes	Firmicutes	positive
Tolumonas auensis	Gammaproteobacteria	negative
Singulisphaera acidiphila	Planctomycetes	negative
Serratia marcescens	Gammaproteobacteria	negative
Peptoniphilus lacrimalis	Firmicutes	positive
Desulfotomaculum carboxydivorans	Firmicutes	positive
Western X	Firmicutes	positive
Actinobacillus pleuropneumoniae	Gammaproteobacteria	negative
Wolinella succinogenes	Epsilonproteobacteria	negative
Desulfobacca acetoxidans	Deltaproteobacteria	negative
Acidiphilium cryptum	Alphaproteobacteria	negative
Mannheimia succiniciproducens	Gammaproteobacteria	negative
Selenomonas sputigena	Firmicutes	negative
Pseudomonas aeruginosa	Gammaproteobacteria	negative
Streptosporangium roseum	Actinobacteria	positive
Leminorella grimontii	Gammaproteobacteria	negative
Escherichia coli	Gammaproteobacteria	negative
Pedobacter sp.	Bacteroidetes/Chlorobi	negative
Neisseria gonorrhoeae	Betaproteobacteria	negative
Streptococcus porcinus	Firmicutes	positive
Paenibacillus alvei	Firmicutes	positive
Shewanella sediminis	Gammaproteobacteria	negative
Haemophilus pittmaniae	Gammaproteobacteria	negative
Leptolyngbya sp.	Cyanobacteria	negative
Psychrobacter cryohalolentis	Gammaproteobacteria	negative
Treponema succinifaciens	Spirochaetes	negative
Desulfovibrio termitidis	Deltaproteobacteria	negative
Marinomonas posidonica	Gammaproteobacteria	negative
Eubacterium sulci	Firmicutes	positive
Campylobacter curvus	Epsilonproteobacteria	negative
Bilophila wadsworthia	Deltaproteobacteria	negative
Clostridiales genomosp.	Firmicutes	positive
Mesorhizobium huakuii	Alphaproteobacteria	negative
Arcobacter molluscorum	Epsilonproteobacteria	negative
Desulfurivibrio alkaliphilus	Deltaproteobacteria	negative
Fructobacillus fructosus	Firmicutes	positive
Dehalococcoides ethenogenes	Chloroflexi	negative
Lactococcus lactis	Firmicutes	positive
Treponema brennaborense	Spirochaetes	negative
Propionibacterium acidifaciens	Actinobacteria	positive
Haemophilus parainfluenzae	Gammaproteobacteria	negative
Paraprevotella xylaniphila	Bacteroidetes/Chlorobi	negative
Chitinophaga pinensis	Bacteroidetes/Chlorobi	negative
Citromicrobium bathyomarinum	Alphaproteobacteria	negative
Pseudomonas sp.	Gammaproteobacteria	negative
Arcobacter trophiarum	Epsilonproteobacteria	negative
Tropheryma whipplei	Actinobacteria	positive
Niabella soli	Bacteroidetes/Chlorobi	negative
Lactobacillus rhamnosus	Firmicutes	positive
Chlamydophila psittaci	Chlamydiae/Verrucomicrobia	negative
Streptomyces	Actinobacteria	positive
Sulfuricurvum kujiense	Epsilonproteobacteria	negative
Clostridium papyrosolvens	Firmicutes	positive
Halonatronum saccharophilum	Firmicutes	negative
Eubacteriaceae bacterium	Firmicutes	positive
Rickettsia bellii	Alphaproteobacteria	negative
Francisella cf.	Gammaproteobacteria	negative
Coprococcus eutactus	Firmicutes	positive
Helicobacter bilis	Epsilonproteobacteria	negative
Hahella chejuensis	Gammaproteobacteria	negative
Prevotella buccae	Bacteroidetes/Chlorobi	negative
Listeria ivanovii	Firmicutes	positive
Bacteroides finegoldii	Bacteroidetes/Chlorobi	negative
Aerococcus viridans	Firmicutes	positive
Coprothermobacter proteolyticus	Firmicutes	negative
Chelativorans sp.	Alphaproteobacteria	negative
Sulfurimonas autotrophica	Epsilonproteobacteria	negative
Dysgonomonas gadei	Bacteroidetes/Chlorobi	negative
SAR202 cluster	Chloroflexi	negative
Anaerostipes sp.	Firmicutes	positive
Flavonifractor plautii	Firmicutes	positive
Clostridium acetobutylicum	Firmicutes	positive
Saccharomonospora xinjiangensis	Actinobacteria	positive
Chloroherpeton thalassium	Bacteroidetes/Chlorobi	negative
Clostridium ramosum	Firmicutes	positive
Oscillatoria sp.	Cyanobacteria	negative
Hyphomicrobium denitrificans	Alphaproteobacteria	negative
Streptococcus thermophilus	Firmicutes	positive
Rheinheimera sp.	Gammaproteobacteria	negative
Borrelia spielmanii	Spirochaetes	negative
Barnesiella intestinihominis	Bacteroidetes/Chlorobi	negative
Acidovorax temperans	Betaproteobacteria	negative
Caulobacter sp.	Alphaproteobacteria	negative
Geminocystis herdmanii	Cyanobacteria	negative
Vibrio brasiliensis	Gammaproteobacteria	negative
Desulfitobacterium metallireducens	Firmicutes	positive
Nitratiruptor sp.	Epsilonproteobacteria	negative
Microvirga sp.	Alphaproteobacteria	negative
Thermocrinis albus	Aquificae	negative
Synechococcus elongatus	Cyanobacteria	negative
Thermotoga thermarum	Thermotogae	negative
Leuconostoc pseudomesenteroides	Firmicutes	positive
Dokdonia donghaensis	Bacteroidetes/Chlorobi	negative
Oceanibulbus indolifex	Alphaproteobacteria	negative
Anoxybacillus flavithermus	Firmicutes	positive
Arthrobacter sp.	Actinobacteria	positive
Shigella boydii	Gammaproteobacteria	negative
Corynebacterium ulcerans	Actinobacteria	positive
Rothia dentocariosa	Actinobacteria	positive
Rhodococcus sp.	Actinobacteria	positive
Burkholderia dolosa	Betaproteobacteria	negative
Dinoroseobacter shibae	Alphaproteobacteria	negative
Leclercia adecarboxylata	Gammaproteobacteria	negative
Eubacterium hallii	Firmicutes	positive
Segniliparus rotundus	Actinobacteria	positive
Agrobacterium radiobacter	Alphaproteobacteria	negative
Leptospira noguchii	Spirochaetes	negative
Silicibacter sp.	Alphaproteobacteria	negative
Rhodobacter sp.	Alphaproteobacteria	negative
Oenococcus kitaharae	Firmicutes	positive
Dialister succinatiphilus	Firmicutes	negative
Conexibacter woesei	Actinobacteria	positive
Burkholderia graminis	Betaproteobacteria	negative
Peptoniphilus duerdenii	Firmicutes	positive
Nocardiopsis sp.	Actinobacteria	positive
Legionella drancourtii	Gammaproteobacteria	negative
Yersinia frederiksenii	Gammaproteobacteria	negative
Actinomyces coleocanis	Actinobacteria	positive
Anaerophaga sp.	Bacteroidetes/Chlorobi	negative
Desulfovibrio alaskensis	Deltaproteobacteria	negative
Brachybacterium squillarum	Actinobacteria	positive
Trichodesmium thiebautii	Cyanobacteria	negative
Marvinbryantia formatexigens	Firmicutes	positive
Clostridium bolteae	Firmicutes	positive
Streptococcus sobrinus	Firmicutes	positive
Actinomyces odontolyticus	Actinobacteria	positive
Anaerococcus tetradius	Firmicutes	positive
Anabaena cylindrica	Cyanobacteria	negative
Desulfovibrio africanus	Deltaproteobacteria	negative
Terriglobus roseus	Acidobacteria	negative
Clostridium hathewayi	Firmicutes	positive
Ectothiorhodospira shaposhnikovii	Gammaproteobacteria	negative
Xanthomonas gardneri	Gammaproteobacteria	negative
Nitrosomonas eutropha	Betaproteobacteria	negative
Bifidobacterium gallicum	Actinobacteria	positive
Bacillus smithii	Firmicutes	positive
Enterococcus faecalis	Firmicutes	positive
Scardovia inopinata	Actinobacteria	positive
Desulfotomaculum ruminis	Firmicutes	positive
Sideroxydans lithotrophicus	Gammaproteobacteria	negative
Kingella kingae	Betaproteobacteria	negative
Heliobacillus mobilis	Firmicutes	negative
Olsenella uli	Actinobacteria	positive
Sinorhizobium medicae	Alphaproteobacteria	negative
Actinomyces cardiffensis	Actinobacteria	positive
Peptostreptococcus anaerobius	Firmicutes	positive
Paenibacillus mucilaginosus	Firmicutes	positive
Clostridium lentocellum	Firmicutes	positive
Arsenophonus nasoniae	Gammaproteobacteria	negative
Acidovorax avenae	Betaproteobacteria	negative
Sulfurihydrogenibium yellowstonense	Aquificae	negative
Prevotella histicola	Bacteroidetes/Chlorobi	negative
Aster yellows	Firmicutes	positive
Methylophaga thiooxydans	Gammaproteobacteria	negative
Tetragenococcus halophilus	Firmicutes	positive
Cupriavidus taiwanensis	Betaproteobacteria	negative
Deinococcus maricopensis	Deinococcus-Thermus	negative
Clostridium celatum	Firmicutes	positive
Clostridium citroniae	Firmicutes	positive
Mycoplasma arthritidis	Firmicutes	negative
Eubacterium sp.	Firmicutes	positive
Clostridium novyi	Firmicutes	positive
Clostridium leptum	Firmicutes	positive
Bacillus clausii	Firmicutes	positive
Oxalobacteraceae bacterium	Betaproteobacteria	negative
Cedecea davisae	Gammaproteobacteria	negative
Ahrensia sp.	Alphaproteobacteria	negative
Baumannia cicadellinicola	Gammaproteobacteria	negative
Streptococcus australis	Firmicutes	positive
Bacillus alcalophilus	Firmicutes	positive
Ruminococcus flavefaciens	Firmicutes	positive
Spirochaeta smaragdinae	Spirochaetes	negative
Streptococcus ratti	Firmicutes	positive
Acidobacterium sp.	Acidobacteria	negative
Staphylococcus caprae	Firmicutes	positive
Collinsella tanakaei	Actinobacteria	positive
Beet leafhopper	Firmicutes	positive
Saprospira grandis	Bacteroidetes/Chlorobi	negative
Vibrio coralliilyticus	Gammaproteobacteria	negative
Onion yellows	Firmicutes	positive
Pseudoalteromonas haloplanktis	Gammaproteobacteria	negative
Pseudoalteromonas sp.	Gammaproteobacteria	negative
Clostridium botulinum	Firmicutes	positive
Microscilla marina	Bacteroidetes/Chlorobi	negative
Coprococcus sp.	Firmicutes	positive
Citrobacter koseri	Gammaproteobacteria	negative
Desulfitobacterium hafniense	Firmicutes	positive
Thermus aquaticus	Deinococcus-Thermus	negative
Dialister invisus	Firmicutes	negative
Phaeobacter gallaeciensis	Alphaproteobacteria	negative
Actinomyces neuii	Actinobacteria	positive
Burkholderia phymatum	Betaproteobacteria	negative
Asticcacaulis biprosthecum	Alphaproteobacteria	negative
Cycloclasticus pugetii	Gammaproteobacteria	negative
Serratia proteamaculans	Gammaproteobacteria	negative
Thermoanaerobacter siderophilus	Firmicutes	positive
Prevotella denticola	Bacteroidetes/Chlorobi	negative
Lactobacillus amylolyticus	Firmicutes	positive
Cyclobacterium marinum	Bacteroidetes/Chlorobi	negative
Prevotella oralis	Bacteroidetes/Chlorobi	negative
Brucella ceti	Alphaproteobacteria	negative
Saccharopolyspora spinosa	Actinobacteria	positive
Coprobacillus sp.	Firmicutes	positive
Yersinia pestis	Gammaproteobacteria	negative
Kocuria rosea	Actinobacteria	positive
Methylobacterium chloromethanicum	Alphaproteobacteria	negative
Saccharopolyspora erythraea	Actinobacteria	positive
Vibrio alginolyticus	Gammaproteobacteria	negative
Hydrogenobacter thermophilus	Aquificae	negative
Eubacterium dolichum	Firmicutes	positive
Streptococcus oralis	Firmicutes	positive
Fusobacterium nucleatum	Fusobacteria	negative
Bifidobacterium dentium	Actinobacteria	positive
Buttiauxella agrestis	Gammaproteobacteria	negative
Loktanella vestfoldensis	Alphaproteobacteria	negative
Streptococcus intermedius	Firmicutes	positive
Actinomyces sp.	Actinobacteria	positive
Caulobacter crescentus	Alphaproteobacteria	negative
Vibrio rotiferianus	Gammaproteobacteria	negative
Collinsella aerofaciens	Actinobacteria	positive
Anaerococcus vaginalis	Firmicutes	positive
Stackebrandtia nassauensis	Actinobacteria	positive
Selenomonas noxia	Firmicutes	negative
Synechocystis sp.	Cyanobacteria	negative
Rickettsia peacockii	Alphaproteobacteria	negative
Shewanella piezotolerans	Gammaproteobacteria	negative
Acidobacterium capsulatum	Acidobacteria	negative
Bacillus thuringiensis	Firmicutes	positive
Thermoanaerobacter italicus	Firmicutes	positive
Bacillus simplex	Firmicutes	positive
Roseovarius sp.	Alphaproteobacteria	negative
Prevotella pallens	Bacteroidetes/Chlorobi	negative
Rhodopseudomonas palustris	Alphaproteobacteria	negative
Butyrivibrio proteoclasticus	Firmicutes	negative
Mycobacterium abscessus	Actinobacteria	positive
Desulfuromonas acetoxidans	Deltaproteobacteria	negative
Actinobaculum massiliae	Actinobacteria	positive
Helicobacter mustelae	Epsilonproteobacteria	negative
Enterococcus casseliflavus	Firmicutes	positive
Nitrospina sp.	Deltaproteobacteria	negative
Bacillus tusciae	Firmicutes	positive
Desulfosporosinus youngiae	Firmicutes	positive
Streptococcus equi	Firmicutes	positive
Nitrosococcus halophilus	Gammaproteobacteria	negative
Desulfonema limicola	Deltaproteobacteria	negative
Helicobacter pylori	Epsilonproteobacteria	negative
Planctomycetes bacterium	Planctomycetes	negative
Pediococcus pentosaceus	Firmicutes	positive
Astrosporangium hypotensionis	Actinobacteria	positive
Lactobacillus casei	Firmicutes	positive
Chlorobaculum parvum	Bacteroidetes/Chlorobi	negative
Fusobacterium necrophorum	Fusobacteria	negative
Brevundimonas diminuta	Alphaproteobacteria	negative
butyrate-producing bacterium	Firmicutes	positive
Haemophilus sp.	Gammaproteobacteria	negative
Brucella abortus	Alphaproteobacteria	negative
Eubacterium siraeum	Firmicutes	positive
Aquiflexum balticum	Bacteroidetes/Chlorobi	negative
Propionibacterium propionicum	Actinobacteria	positive
Hydrogenivirga sp.	Aquificae	negative
Ilyobacter polytropus	Fusobacteria	negative
Actinomyces gerencseriae	Actinobacteria	positive
Pseudomonas savastanoi	Gammaproteobacteria	negative
Sutterella parvirubra	Betaproteobacteria	negative
Streptococcus agalactiae	Firmicutes	positive
Idiomarina baltica	Gammaproteobacteria	negative
Vibrio navarrensis	Gammaproteobacteria	negative
Gallibacterium anatis	Gammaproteobacteria	negative
Pseudomonas gingeri	Gammaproteobacteria	negative
Francisella sp.	Gammaproteobacteria	negative
Atopobium minutum	Actinobacteria	positive
Shewanella woodyi	Gammaproteobacteria	negative
Rhodococcus erythropolis	Actinobacteria	positive
Shewanella pealeana	Gammaproteobacteria	negative
Slackia heliotrinireducens	Actinobacteria	positive
Hymenobacter roseosalivarius	Bacteroidetes/Chlorobi	negative
Burkholderia unamae	Betaproteobacteria	negative
Belliella baltica	Bacteroidetes/Chlorobi	negative
Geobacter sp.	Deltaproteobacteria	negative
Brachybacterium muris	Actinobacteria	positive
Anaerostipes caccae	Firmicutes	positive
Mycobacterium chelonae	Actinobacteria	positive
Spiroplasma mirum	Tenericutes	positive
Acetobacter pomorum	Alphaproteobacteria	negative
Petrotoga miotherma	Thermotogae	negative
Oenococcus oeni	Firmicutes	positive
Gloeobacter violaceus	Cyanobacteria	negative
Spirochaeta africana	Spirochaetes	negative
Prevotella melaninogenica	Bacteroidetes/Chlorobi	negative
Slackia piriformis	Actinobacteria	positive
Bacteroides vulgatus	Bacteroidetes/Chlorobi	negative
Treponema pallidum	Spirochaetes	negative
Shigella sonnei	Gammaproteobacteria	negative
Acinetobacter johnsonii	Gammaproteobacteria	negative
Eubacterium saphenum	Firmicutes	positive
Pseudomonas agarici	Gammaproteobacteria	negative
Planococcus donghaensis	Firmicutes	positive
Prevotella salivae	Bacteroidetes/Chlorobi	negative
Corynebacterium accolens	Actinobacteria	positive
Actinomyces naeslundii	Actinobacteria	positive
Staphylococcus simiae	Firmicutes	positive
Halomonas sp.	Gammaproteobacteria	negative
Pseudoxanthomonas spadix	Gammaproteobacteria	negative
Fusobacterium mortiferum	Fusobacteria	negative
Sodalis glossinidius	Gammaproteobacteria	negative
Kluyvera ascorbata	Gammaproteobacteria	negative
Streptococcus mitis	Firmicutes	positive
Edwardsiella tarda	Gammaproteobacteria	negative
Pseudonocardia sp.	Actinobacteria	positive
Enterobacter mori	Gammaproteobacteria	negative
Clostridium kluyveri	Firmicutes	positive
Cronobacter sakazakii	Gammaproteobacteria	negative
Streptococcus bovis	Firmicutes	positive
Frankia sp.	Actinobacteria	positive
Selenomonas flueggei	Firmicutes	negative
Polymorphum gilvum	Alphaproteobacteria	negative
Thermoanaerobacter pseudethanolicus	Firmicutes	positive
Rhodopirellula baltica	Planctomycetes	negative
Bordetella bronchiseptica	Betaproteobacteria	negative
Pseudomonas chlororaphis	Gammaproteobacteria	negative
Pseudoalteromonas atlantica	Gammaproteobacteria	negative
Wigglesworthia glossinidia	Gammaproteobacteria	negative
Faecalibacterium prausnitzii	Firmicutes	negative
Brachyspira pilosicoli	Spirochaetes	negative
Pantoea ananatis	Gammaproteobacteria	negative
Slackia exigua	Actinobacteria	positive
Rubrivivax gelatinosus	Betaproteobacteria	negative
Ferrimonas balearica	Gammaproteobacteria	negative
Leptotrichia wadei	Fusobacteria	negative
Novosphingobium aromaticivorans	Alphaproteobacteria	negative
Sulfitobacter sp.	Alphaproteobacteria	negative
Prevotella marshii	Bacteroidetes/Chlorobi	negative
SAR 116	Alphaproteobacteria	negative
Borrelia turicatae	Spirochaetes	negative
Meiothermus silvanus	Deinococcus-Thermus	negative
Thermaerobacter subterraneus	Firmicutes	positive
Mahella australiensis	Firmicutes	positive
Streptomyces avermitilis	Actinobacteria	positive
Enterobacteriaceae bacterium	Gammaproteobacteria	negative
Streptococcus parauberis	Firmicutes	positive
Facklamia ignava	Firmicutes	positive
Peptoniphilus asaccharolyticus	Firmicutes	positive
Clostridium saccharolyticum	Firmicutes	positive
Facklamia languida	Firmicutes	positive
Prevotella maculosa	Bacteroidetes/Chlorobi	negative
Labrenzia aggregata	Alphaproteobacteria	negative
Gemmata obscuriglobus	Planctomycetes	negative
Oscillatoriales cyanobacterium	Cyanobacteria	negative
Peptoniphilus indolicus	Firmicutes	positive
Citreicella sp.	Alphaproteobacteria	negative
Prevotella dentalis	Bacteroidetes/Chlorobi	negative
Ruminococcus obeum	Firmicutes	positive
Sphingobium yanoikuyae	Alphaproteobacteria	negative
Weeksella virosa	Bacteroidetes/Chlorobi	negative
Streptacidiphilus rugosus	Actinobacteria	positive
Lactobacillus pentosus	Firmicutes	positive
Caldanaerobius polysaccharolyticus	Firmicutes	positive
Rickettsia akari	Alphaproteobacteria	negative
Xanthomonas vesicatoria	Gammaproteobacteria	negative
Massilia timonae	Betaproteobacteria	negative
Lactobacillus kefiranofaciens	Firmicutes	positive
Roseomonas cervicalis	Alphaproteobacteria	negative
Ochrobactrum anthropi	Alphaproteobacteria	negative
Kosmotoga olearia	Thermotogae	negative
Desulfovibrio desulfuricans	Deltaproteobacteria	negative
Pelobacter carbinolicus	Deltaproteobacteria	negative
Actinobacillus succinogenes	Gammaproteobacteria	negative
Hyphomonas neptunium	Alphaproteobacteria	negative
Bacteroides thetaiotaomicron	Bacteroidetes/Chlorobi	negative
Lactobacillus jensenii	Firmicutes	positive
Rhizobium sp.	Alphaproteobacteria	negative
Fusobacterium ulcerans	Fusobacteria	negative
Parabacteroides goldsteinii	Bacteroidetes/Chlorobi	negative
Methylovorus glucosetrophus	Betaproteobacteria	negative
Pseudomonas fluorescens	Gammaproteobacteria	negative
Streptomyces coelicolor	Actinobacteria	positive
Streptomyces bingchenggensis	Actinobacteria	positive
Bifidobacterium adolescentis	Actinobacteria	positive
Janibacter sp.	Actinobacteria	positive
Robiginitalea biformata	Bacteroidetes/Chlorobi	negative
Zooshikella rubidus	Gammaproteobacteria	negative
Anaeroglobus geminatus	Firmicutes	negative
Pelotomaculum thermopropionicum	Firmicutes	positive
Anaerolinea thermophila	Chloroflexi	negative
Microbacterium lacticum	Actinobacteria	positive
Burkholderia ambifaria	Betaproteobacteria	negative
Plectonema sp.	Cyanobacteria	negative
Shewanella amazonensis	Gammaproteobacteria	negative
Shewanella baltica	Gammaproteobacteria	negative
Afipia clevelandensis	Alphaproteobacteria	negative
Thiobacillus denitrificans	Betaproteobacteria	negative
Truepera radiovictrix	Deinococcus-Thermus	negative
Dolosigranulum pigrum	Firmicutes	positive
Holophaga foetida	Acidobacteria	negative
Sutterella wadsworthensis	Betaproteobacteria	negative
Leuconostoc citreum	Firmicutes	positive
Helicobacter winghamensis	Epsilonproteobacteria	negative
Gluconacetobacter diazotrophicus	Alphaproteobacteria	negative
Pediococcus claussenii	Firmicutes	positive
Enterobacter asburiae	Gammaproteobacteria	negative
Oligotropha carboxidovorans	Alphaproteobacteria	negative
Helicobacter suis	Epsilonproteobacteria	negative
Thauera selenatis	Betaproteobacteria	negative
Abiotrophia defectiva	Firmicutes	positive
Paenibacillus polymyxa	Firmicutes	positive
Rhodobacteraceae bacterium	Alphaproteobacteria	negative
Arthrobacter arilaitensis	Actinobacteria	positive
Vibrio fischeri	Gammaproteobacteria	negative
Shewanella halifaxensis	Gammaproteobacteria	negative
Bacillus coagulans	Firmicutes	positive
Arcobacter sp.	Epsilonproteobacteria	negative
Deinococcus proteolyticus	Deinococcus-Thermus	negative
Cardiobacterium hominis	Gammaproteobacteria	negative
Bacillus mycoides	Firmicutes	positive
Idiomarina loihiensis	Gammaproteobacteria	negative
Eubacterium hadrum	Firmicutes	positive
Saccharomonospora glauca	Actinobacteria	positive
Verminephrobacter eiseniae	Betaproteobacteria	negative
Olsenella profusa	Actinobacteria	positive
Mucilaginibacter paludis	Bacteroidetes/Chlorobi	negative
Enterococcus durans	Firmicutes	positive
Clostridium cellulovorans	Firmicutes	positive
Desulfosporosinus orientis	Firmicutes	positive
Thermanaeromonas toyohensis	Firmicutes	positive
Achromobacter xylosoxidans	Betaproteobacteria	negative
Tannerella sp.	Bacteroidetes/Chlorobi	negative
Mycobacterium chubuense	Actinobacteria	positive
Prosthecochloris sp.	Bacteroidetes/Chlorobi	negative
Anaerotruncus colihominis	Firmicutes	positive
Thiorhodovibrio sp.	Gammaproteobacteria	negative
Clostridium cf.	Firmicutes	positive
Nesterenkonia sp.	Actinobacteria	positive
Butyrivibrio fibrisolvens	Firmicutes	negative
Campylobacter jejuni	Epsilonproteobacteria	negative
Brevundimonas subvibrioides	Alphaproteobacteria	negative
Chromohalobacter salexigens	Gammaproteobacteria	negative
Borrelia afzelii	Spirochaetes	negative
Xanthomonas albilineans	Gammaproteobacteria	negative
Parabacteroides johnsonii	Bacteroidetes/Chlorobi	negative
Halomonas boliviensis	Gammaproteobacteria	negative
Flavobacteria bacterium	Bacteroidetes/Chlorobi	negative
Phenylobacterium zucineum	Alphaproteobacteria	negative
Clostridium beijerinckii	Firmicutes	positive
Acholeplasma laidlawii	Firmicutes	negative
Renibacterium salmoninarum	Actinobacteria	positive
Streptococcus uberis	Firmicutes	positive
Bartonella quintana	Alphaproteobacteria	negative
Collinsella stercoris	Actinobacteria	positive
Barnesiella viscericola	Bacteroidetes/Chlorobi	negative
Serinicoccus marinus	Actinobacteria	positive
Parachlamydia acanthamoebae	Chlamydiae/Verrucomicrobia	negative
Neisseria wadsworthii	Betaproteobacteria	negative
Staphylococcus saprophyticus	Firmicutes	positive
Geobacter sulfurreducens	Deltaproteobacteria	negative
Actinobacillus minor	Gammaproteobacteria	negative
Cupriavidus metallidurans	Betaproteobacteria	negative
Oceanobacillus iheyensis	Firmicutes	positive
Lactobacillus reuteri	Firmicutes	positive
Capnocytophaga ochracea	Bacteroidetes/Chlorobi	negative
Desulfobacter postgatei	Deltaproteobacteria	negative
Arcobacter butzleri	Epsilonproteobacteria	negative
Fusobacterium varium	Fusobacteria	negative
Sulfurihydrogenibium azorense	Aquificae	negative
Porphyromonas sp.	Bacteroidetes/Chlorobi	negative
Raoultella planticola	Gammaproteobacteria	negative
Mycobacterium sp.	Actinobacteria	positive
Klebsiella sp.	Gammaproteobacteria	negative
Fischerella sp.	Cyanobacteria	negative
Hirschia baltica	Alphaproteobacteria	negative
Endoriftia persephone	Gammaproteobacteria	negative
Flexibacter litoralis	Bacteroidetes/Chlorobi	negative
Lactobacillus helveticus	Firmicutes	positive
Alloiococcus otitis	Firmicutes	positive
Moraxella catarrhalis	Gammaproteobacteria	negative
Listeria marthii	Firmicutes	positive
Streptococcus sp.	Firmicutes	positive
Ruminococcus callidus	Firmicutes	positive
Cylindrospermopsis raciborskii	Cyanobacteria	negative
Sagittula stellata	Alphaproteobacteria	negative
Bacillus atrophaeus	Firmicutes	positive
Neisseria shayeganii	Betaproteobacteria	negative
Sorangium cellulosum	Deltaproteobacteria	negative
Sphingobium indicum	Alphaproteobacteria	negative
Desulfovibrio magneticus	Deltaproteobacteria	negative
Caulobacter segnis	Alphaproteobacteria	negative
Desulfovibrio vulgaris	Deltaproteobacteria	negative
Acetobacter tropicalis	Alphaproteobacteria	negative
Legionella pneumophila	Gammaproteobacteria	negative
Mycobacterium vanbaalenii	Actinobacteria	positive
Ehrlichia canis	Alphaproteobacteria	negative
Desulfatibacillum alkenivorans	Deltaproteobacteria	negative
Azorhizobium caulinodans	Alphaproteobacteria	negative
Kangiella koreensis	Gammaproteobacteria	negative
Phormidium sp.	Cyanobacteria	negative
Polaribacter irgensii	Bacteroidetes/Chlorobi	negative
Corynebacterium bovis	Actinobacteria	positive
Catonella morbi	Firmicutes	negative
Methyloversatilis universalis	Betaproteobacteria	negative
Treponema denticola	Spirochaetes	negative
Streptobacillus moniliformis	Fusobacteria	negative
Methylovorus sp.	Betaproteobacteria	negative
Fusobacterium sp.	Fusobacteria	negative
Dehalococcoides sp.	Chloroflexi	negative
Deinococcus hopiensis	Deinococcus-Thermus	negative
Natranaerobius thermophilus	Firmicutes	positive
Fervidobacterium nodosum	Thermotogae	negative
Providencia alcalifaciens	Gammaproteobacteria	negative
Desulfosarcina variabilis	Deltaproteobacteria	negative
Micromonospora sp.	Actinobacteria	positive
Listeria welshimeri	Firmicutes	positive
Sinorhizobium meliloti	Alphaproteobacteria	negative
Bacillus licheniformis	Firmicutes	positive
Thermoanaerobacter wiegelii	Firmicutes	positive
Megasphaera elsdenii	Firmicutes	negative
Cardiobacterium valvarum	Gammaproteobacteria	negative
Sulfurospirillum barnesii	Epsilonproteobacteria	negative
Vibrio sp.	Gammaproteobacteria	negative
Streptococcus iniae	Firmicutes	positive
Dehalobium chlorocoercia	Chloroflexi	negative
Lactobacillus amylovorus	Firmicutes	positive
Roseobacter sp.	Alphaproteobacteria	negative
Actinosynnema mirum	Actinobacteria	positive
Leuconostoc sp.	Firmicutes	positive
Thauera aromatica	Betaproteobacteria	negative
Brucella microti	Alphaproteobacteria	negative
Catenibacterium mitsuokai	Firmicutes	positive
Thioalkalimicrobium cyclicum	Gammaproteobacteria	negative
Ruminococcus gnavus	Firmicutes	positive
Clostridium cellulolyticum	Firmicutes	positive
Legionella longbeachae	Gammaproteobacteria	negative
Streptococcus pasteurianus	Firmicutes	positive
Klebsiella variicola	Gammaproteobacteria	negative
Mycobacterium ulcerans	Actinobacteria	positive
Blautia hydrogenotrophica	Firmicutes	positive
Subdoligranulum sp.	Firmicutes	negative
Bacteroides cellulosilyticus	Bacteroidetes/Chlorobi	negative
Neisseria bacilliformis	Betaproteobacteria	negative
Lactobacillus fermentum	Firmicutes	positive
Methylophilales bacterium	Betaproteobacteria	negative
Nocardioidaceae bacterium	Actinobacteria	positive
Thermaerobacter marianensis	Firmicutes	positive
Neisseria meningitidis	Betaproteobacteria	negative
Rickettsia sibirica	Alphaproteobacteria	negative
Spirochaeta coccoides	Spirochaetes	negative
Bacillus megaterium	Firmicutes	positive
Prevotella bryantii	Bacteroidetes/Chlorobi	negative
Wolbachia sp.	Alphaproteobacteria	negative
Lactobacillus malefermentans	Firmicutes	positive
Borrelia hermsii	Spirochaetes	negative
Thioalkalivibrio sp.	Gammaproteobacteria	negative
Bacteroides fragilis	Bacteroidetes/Chlorobi	negative
Joostella marina	Bacteroidetes/Chlorobi	negative
Dehalobacter restrictus	Firmicutes	negative
Novosphingobium nitrogenifigens	Alphaproteobacteria	negative
Mobiluncus mulieris	Actinobacteria	positive
Enterococcus hirae	Firmicutes	positive
Escherichia blattae	Gammaproteobacteria	negative
Sphingobacterium spiritivorum	Bacteroidetes/Chlorobi	negative
Dickeya zeae	Gammaproteobacteria	negative
Alteromonas macleodii	Gammaproteobacteria	negative
Bacillus amyloliquefaciens	Firmicutes	positive
Plesiocystis pacifica	Deltaproteobacteria	negative
Rickettsia heilongjiangensis	Alphaproteobacteria	negative
Ketogulonicigenium vulgare	Alphaproteobacteria	negative
Pseudomonas mendocina	Gammaproteobacteria	negative
Psychrobacter arcticus	Gammaproteobacteria	negative
Photorhabdus temperata	Gammaproteobacteria	negative
Caminibacter mediatlanticus	Epsilonproteobacteria	negative
Gluconacetobacter hansenii	Alphaproteobacteria	negative
Spirochaeta aurantia	Spirochaetes	negative
Actinobaculum schaalii	Actinobacteria	positive
Acidimicrobidae bacterium	Actinobacteria	positive
Ruminococcus albus	Firmicutes	positive
Prevotella nigrescens	Bacteroidetes/Chlorobi	negative
Erwinia pyrifoliae	Gammaproteobacteria	negative
Ramlibacter tataouinensis	Betaproteobacteria	negative
Jannaschia sp.	Alphaproteobacteria	negative
Bacteroides plebeius	Bacteroidetes/Chlorobi	negative
Clostridium difficile	Firmicutes	positive
Vibrio splendidus	Gammaproteobacteria	negative
Nostoc punctiforme	Cyanobacteria	negative
Rhodococcus ruber	Actinobacteria	positive
Corynebacterium variabile	Actinobacteria	positive
Corynebacterium coyleae	Actinobacteria	positive
Parascardovia denticolens	Actinobacteria	positive
Kurthia sp.	Firmicutes	positive
Bacillus halodurans	Firmicutes	positive
Herpetosiphon aurantiacus	Chloroflexi	negative
Bifidobacterium angulatum	Actinobacteria	positive
Prevotella tannerae	Bacteroidetes/Chlorobi	negative
Treponema paraluiscuniculi	Spirochaetes	negative
Streptococcus gallolyticus	Firmicutes	positive
Clostridiales bacterium	Firmicutes	positive
Bifidobacterium longum	Actinobacteria	positive
Streptococcus parasanguinis	Firmicutes	positive
Rothia mucilaginosa	Actinobacteria	positive
Amycolatopsis sp.	Actinobacteria	positive
Yersinia pseudotuberculosis	Gammaproteobacteria	negative
Brenneria salicis	Gammaproteobacteria	negative
Pseudomonas stutzeri	Gammaproteobacteria	negative
Azospirillum lipoferum	Alphaproteobacteria	negative
Yersinia rohdei	Gammaproteobacteria	negative
Asticcacaulis excentricus	Alphaproteobacteria	negative
Eggerthella lenta	Actinobacteria	positive
Barnesiella sp.	Bacteroidetes/Chlorobi	negative
Bacillus cereus	Firmicutes	positive
Myxococcus xanthus	Deltaproteobacteria	negative
Syntrophobacter fumaroxidans	Deltaproteobacteria	negative
Eggerthella sinensis	Actinobacteria	positive
Planktothrix rubescens	Cyanobacteria	negative
Rickettsia rickettsii	Alphaproteobacteria	negative
uncultured Curvibacter	Betaproteobacteria	negative
Bartonella bacilliformis	Alphaproteobacteria	negative
Croceibacter atlanticus	Bacteroidetes/Chlorobi	negative
Staphylococcus warneri	Firmicutes	positive
Parvibaculum lavamentivorans	Alphaproteobacteria	negative
Cyanobacterium stanieri	Cyanobacteria	negative
Pantoea stewartii	Gammaproteobacteria	negative
Bacteroides fluxus	Bacteroidetes/Chlorobi	negative
Paenibacillus elgii	Firmicutes	positive
Paenibacillus lactis	Firmicutes	positive
Bilophila sp.	Deltaproteobacteria	negative
Catenulispora acidiphila	Actinobacteria	positive
Vibrio vulnificus	Gammaproteobacteria	negative
Leuconostoc inhae	Firmicutes	positive
blood disease	Betaproteobacteria	negative
Mycoplasma bovis	Firmicutes	negative
Burkholderia rhizoxinica	Betaproteobacteria	negative
Pseudomonas syringae	Gammaproteobacteria	negative
Clostridium carboxidivorans	Firmicutes	positive
Paenibacillus riograndensis	Firmicutes	positive
Pectobacterium carotovorum	Gammaproteobacteria	negative
Prevotella bivia	Bacteroidetes/Chlorobi	negative
Flavobacterium columnare	Bacteroidetes/Chlorobi	negative
Staphylococcus simulans	Firmicutes	positive
Azospirillum sp.	Alphaproteobacteria	negative
Tepidanaerobacter sp.	Firmicutes	positive
Brucella ovis	Alphaproteobacteria	negative
Methylosinus trichosporium	Alphaproteobacteria	negative
Erwinia billingiae	Gammaproteobacteria	negative
Marinithermus hydrothermalis	Deinococcus-Thermus	negative
Sphingomonas wittichii	Alphaproteobacteria	negative
Prevotella micans	Bacteroidetes/Chlorobi	negative
Dermacoccus sp.	Actinobacteria	positive
Burkholderia pseudomallei	Betaproteobacteria	negative
Rhodobacter capsulatus	Alphaproteobacteria	negative
Chlorobium ferrooxidans	Bacteroidetes/Chlorobi	negative
Yokenella regensburgei	Gammaproteobacteria	negative
Clostridium phytofermentans	Firmicutes	positive
Collinsella intestinalis	Actinobacteria	positive
Gordonia neofelifaecis	Actinobacteria	positive
Desulfotomaculum gibsoniae	Firmicutes	positive
Verrucosispora maris	Actinobacteria	positive
Selenomonas infelix	Firmicutes	negative
Chloroflexus aggregans	Chloroflexi	negative
Chlamydophila felis	Chlamydiae/Verrucomicrobia	negative
Methylotenera versatilis	Betaproteobacteria	negative
Providencia stuartii	Gammaproteobacteria	negative
Haemophilus aegyptius	Gammaproteobacteria	negative
Streptococcus canis	Firmicutes	positive
Bacillus methanolicus	Firmicutes	positive
Citrobacter rodentium	Gammaproteobacteria	negative
Cryptobacterium curtum	Actinobacteria	positive
Pasteuria ramosa	Firmicutes	positive
Desulfovibrio aespoeensis	Deltaproteobacteria	negative
Clostridium innocuum	Firmicutes	positive
Desulfovibrio sp.	Deltaproteobacteria	negative
Burkholderia thailandensis	Betaproteobacteria	negative
Aeromonas salmonicida	Gammaproteobacteria	negative
Haemophilus somnus	Gammaproteobacteria	negative
Proteus mirabilis	Gammaproteobacteria	negative
Thermovibrio ammonificans	Aquificae	negative
Rickettsia canadensis	Alphaproteobacteria	negative
Colwellia psychrerythraea	Gammaproteobacteria	negative
Jonesia denitrificans	Actinobacteria	positive
Bartonella rochalimae	Alphaproteobacteria	negative
Caldicellulosiruptor owensensis	Firmicutes	positive
Taylorella asinigenitalis	Betaproteobacteria	negative
Propionimicrobium lymphophilum	Actinobacteria	positive
Megasphaera micronuciformis	Firmicutes	negative
Streptomyces xinghaiensis	Actinobacteria	positive
Neisseria subflava	Betaproteobacteria	negative
Lactobacillus zeae	Firmicutes	positive
Halomonas sulfidaeris	Gammaproteobacteria	negative
Lautropia mirabilis	Betaproteobacteria	negative
Clostridium hylemonae	Firmicutes	positive
Deinococcus radiodurans	Deinococcus-Thermus	negative
Acidithiobacillus ferrooxidans	Gammaproteobacteria	negative
Delftia acidovorans	Betaproteobacteria	negative
Thermobifida fusca	Actinobacteria	positive
Prevotella multisaccharivorax	Bacteroidetes/Chlorobi	negative
Oceanicaulis sp.	Alphaproteobacteria	negative
Xenorhabdus bovienii	Gammaproteobacteria	negative
Neisseria elongata	Betaproteobacteria	negative
Planctomyces limnophilus	Planctomycetes	negative
Acinetobacter junii	Gammaproteobacteria	negative
Gluconacetobacter xylinus	Alphaproteobacteria	negative
Thermosediminibacter oceani	Firmicutes	negative
Gemella haemolysans	Firmicutes	positive
Chlamydophila caviae	Chlamydiae/Verrucomicrobia	negative
Actinomyces graevenitzii	Actinobacteria	positive
Francisella novicida	Gammaproteobacteria	negative
Thermobispora bispora	Actinobacteria	positive
Beggiatoa sp.	Gammaproteobacteria	negative
Listonella anguillarum	Gammaproteobacteria	negative
Chlorobium limicola	Bacteroidetes/Chlorobi	negative
Prevotella veroralis	Bacteroidetes/Chlorobi	negative
Trabulsiella guamensis	Gammaproteobacteria	negative
Arcobacter skirrowii	Epsilonproteobacteria	negative
Ethanoligenens harbinense	Firmicutes	positive
Geobacillus stearothermophilus	Firmicutes	positive
Thermobrachium celere	Firmicutes	positive
Polaribacter sp.	Bacteroidetes/Chlorobi	negative
Oceanimonas sp.	Gammaproteobacteria	negative
Kocuria rhizophila	Actinobacteria	positive
Parvularcula bermudensis	Alphaproteobacteria	negative
Microcoleus vaginatus	Cyanobacteria	negative
Roseibium sp.	Alphaproteobacteria	negative
Chroococcidiopsis thermalis	Cyanobacteria	negative
Borrelia duttonii	Spirochaetes	negative
Lactobacillus sakei	Firmicutes	positive
Tatumella ptyseos	Gammaproteobacteria	negative
Krokinobacter diaphorus	Bacteroidetes/Chlorobi	negative
Saccharomonospora azurea	Actinobacteria	positive
Mycoplasma orale	Firmicutes	negative
Anaerococcus hydrogenalis	Firmicutes	positive
Clostridium pasteurianum	Firmicutes	positive
Segniliparus rugosus	Actinobacteria	positive
Solibacillus silvestris	Firmicutes	positive
Roseburia faecis	Firmicutes	positive
Rhizobium galegae	Alphaproteobacteria	negative
Dysgonomonas mossii	Bacteroidetes/Chlorobi	negative
Bacillus cytotoxicus	Firmicutes	positive
Wolbachia endosymbiont	Alphaproteobacteria	negative
Coxiella burnetii	Gammaproteobacteria	negative
Peptoniphilus sp.	Firmicutes	positive
Glaciecola sp.	Gammaproteobacteria	negative
Atopobium vaginae	Actinobacteria	positive
Burkholderia gladioli	Betaproteobacteria	negative
gamma proteobacterium	Gammaproteobacteria	negative
Synechococcus sp.	Cyanobacteria	negative
Agrobacterium tumefaciens	Alphaproteobacteria	negative
Streptomyces flavogriseus	Actinobacteria	positive
Sebaldella termitidis	Fusobacteria	negative
Rickettsiella grylli	Gammaproteobacteria	negative
Fusobacterium periodonticum	Fusobacteria	negative
Thioflavicoccus mobilis	Gammaproteobacteria	negative
Bacteroides pectinophilus	Bacteroidetes/Chlorobi	negative
Mycoplasma genitalium	Firmicutes	negative
Bifidobacterium animalis	Actinobacteria	positive
Streptomyces viridochromogenes	Actinobacteria	positive
Streptomyces scabiei	Actinobacteria	positive
Lactobacillus ultunensis	Firmicutes	positive
beta proteobacterium	Betaproteobacteria	negative
SAR324 cluster	Deltaproteobacteria	negative
Mycobacterium parascrofulaceum	Actinobacteria	positive
Sphingobium sp.	Alphaproteobacteria	negative
Ralstonia syzygii	Betaproteobacteria	negative
Chlorobium phaeovibrioides	Bacteroidetes/Chlorobi	negative
Sulfurospirillum deleyianum	Epsilonproteobacteria	negative
Blautia luti	Firmicutes	positive
Zymomonas mobilis	Alphaproteobacteria	negative
Idiomarina sp.	Gammaproteobacteria	negative
Bacteroides salyersiae	Bacteroidetes/Chlorobi	negative
Corynebacterium amycolatum	Actinobacteria	positive
Ehrlichia ruminantium	Alphaproteobacteria	negative
Aromatoleum aromaticum	Betaproteobacteria	negative
Nitrobacter sp.	Alphaproteobacteria	negative
Prevotella disiens	Bacteroidetes/Chlorobi	negative
Methylobacterium oryzae	Alphaproteobacteria	negative
Thermochromatium tepidum	Gammaproteobacteria	negative
Yersinia enterocolitica	Gammaproteobacteria	negative
Caloramator australicus	Firmicutes	positive
Maricaulis maris	Alphaproteobacteria	negative
Thermomicrobium roseum	Chloroflexi	negative
Microcystis aeruginosa	Cyanobacteria	negative
Geobacillus thermoglucosidasius	Firmicutes	positive
Vibrio mimicus	Gammaproteobacteria	negative
Arthrobacter phenanthrenivorans	Actinobacteria	positive
Lachnospiraceae oral	Firmicutes	positive
Lactobacillus coleohominis	Firmicutes	positive
Arthrospira platensis	Cyanobacteria	negative
Treponema primitia	Spirochaetes	negative
Burkholderia xenovorans	Betaproteobacteria	negative
Bacillus weihenstephanensis	Firmicutes	positive
Anaplasma centrale	Alphaproteobacteria	negative
Corynebacterium kroppenstedtii	Actinobacteria	positive
Chlorobium phaeobacteroides	Bacteroidetes/Chlorobi	negative
Selenomonas artemidis	Firmicutes	negative
Bacillus pumilus	Firmicutes	positive
Azospirillum amazonense	Alphaproteobacteria	negative
Bifidobacterium breve	Actinobacteria	positive
Oscillibacter valericigenes	Firmicutes	negative
Acinetobacter ursingii	Gammaproteobacteria	negative
Blautia hansenii	Firmicutes	positive
Actinomyces europaeus	Actinobacteria	positive
Streptomyces sviceus	Actinobacteria	positive
Ectothiorhodospira sp.	Gammaproteobacteria	negative
Haemophilus influenzae	Gammaproteobacteria	negative
Propionibacterium freudenreichii	Actinobacteria	positive
Achromobacter piechaudii	Betaproteobacteria	negative
Alteromonas sp.	Gammaproteobacteria	negative
Clostridium nexile	Firmicutes	positive
Deinococcus pimensis	Deinococcus-Thermus	negative
Acetobacter aceti	Alphaproteobacteria	negative
Acidothermus cellulolyticus	Actinobacteria	positive
Desulfosporosinus sp.	Firmicutes	positive
Chlamydophila pneumoniae	Chlamydiae/Verrucomicrobia	negative
Vibrio orientalis	Gammaproteobacteria	negative
Bradyrhizobiaceae bacterium	Alphaproteobacteria	negative
Nostoc azollae	Cyanobacteria	negative
Sanguibacter keddieii	Actinobacteria	positive
Anabaena variabilis	Cyanobacteria	negative
Chromobacterium sp.	Betaproteobacteria	negative
Rahnella aquatilis	Gammaproteobacteria	negative
Klebsiella oxytoca	Gammaproteobacteria	negative
Roseiflexus sp.	Chloroflexi	negative
Neorickettsia sennetsu	Alphaproteobacteria	negative
Staphylococcus capitis	Firmicutes	positive
Roseiflexus castenholzii	Chloroflexi	negative
Bacteroidetes bacterium	Bacteroidetes/Chlorobi	negative
Dorea sp.	Firmicutes	positive
Geobacillus thermodenitrificans	Firmicutes	positive
Clostridium saccharoperbutylacetonicum	Firmicutes	positive
Bacteroides heparinolyticus	Bacteroidetes/Chlorobi	negative
Thermoanaerobacterium thermosaccharolyticum	Firmicutes	positive
Desulfarculus baarsii	Deltaproteobacteria	negative
Meiothermus chliarophilus	Deinococcus-Thermus	negative
Ruminococcus lactaris	Firmicutes	positive
Acinetobacter haemolyticus	Gammaproteobacteria	negative
Eubacterium saburreum	Firmicutes	positive
Rubrobacter xylanophilus	Actinobacteria	positive
Prevotella stercorea	Bacteroidetes/Chlorobi	negative
Pantoea vagans	Gammaproteobacteria	negative
Parabacteroides merdae	Bacteroidetes/Chlorobi	negative
Thermus oshimai	Deinococcus-Thermus	negative
Frankia symbiont	Actinobacteria	positive
Orientia tsutsugamushi	Alphaproteobacteria	negative
Prevotella oulorum	Bacteroidetes/Chlorobi	negative
Anaerofustis stercorihominis	Firmicutes	positive
Roseobacter litoralis	Alphaproteobacteria	negative
Streptomyces pristinaespiralis	Actinobacteria	positive
Staphylococcus carnosus	Firmicutes	positive
Clostridium clostridioforme	Firmicutes	positive
Deinococcus gobiensis	Deinococcus-Thermus	negative
Leptospira weilii	Spirochaetes	negative
Desulfobulbus propionicus	Deltaproteobacteria	negative
Enterobacter hormaechei	Gammaproteobacteria	negative
Gluconobacter oxydans	Alphaproteobacteria	negative
Janthinobacterium sp.	Betaproteobacteria	negative
Thermobacillus composti	Firmicutes	positive
Verminephrobacter sp.	Betaproteobacteria	negative
Salinisphaera shabanensis	Gammaproteobacteria	negative
Bacteroides coprocola	Bacteroidetes/Chlorobi	negative
Leptospira borgpetersenii	Spirochaetes	negative
Lactobacillus suebicus	Firmicutes	positive
Stenotrophomonas sp.	Gammaproteobacteria	negative
Psychrobacter sp.	Gammaproteobacteria	negative
Actinomyces viscosus	Actinobacteria	positive
Enhydrobacter aerosaccus	Gammaproteobacteria	negative
Glaciecola agarilytica	Gammaproteobacteria	negative
Aneurinibacillus aneurinilyticus	Firmicutes	positive
Atopobium sp.	Actinobacteria	positive
Escherichia sp.	Gammaproteobacteria	negative
Thalassospira sp.	Alphaproteobacteria	negative
Sphingobium chlorophenolicum	Alphaproteobacteria	negative
Mesorhizobium loti	Alphaproteobacteria	negative
Brucella neotomae	Alphaproteobacteria	negative
Campylobacter sputorum	Epsilonproteobacteria	negative
Bordetella parapertussis	Betaproteobacteria	negative
Rickettsia prowazekii	Alphaproteobacteria	negative
Acidithiobacillus thiooxidans	Gammaproteobacteria	negative
Cronobacter turicensis	Gammaproteobacteria	negative
Enterobacter	Gammaproteobacteria	negative
Thalassiobium sp.	Alphaproteobacteria	negative
Paenibacillus sp.	Firmicutes	positive
Desulfomonile tiedjei	Deltaproteobacteria	negative
Corynebacterium ammoniagenes	Actinobacteria	positive
Psychromonas ingrahamii	Gammaproteobacteria	negative
Pseudomonas brassicacearum	Gammaproteobacteria	negative
Persicivirga dokdonensis	Bacteroidetes/Chlorobi	negative
Bartonella tribocorum	Alphaproteobacteria	negative
Saccharomonospora marina	Actinobacteria	positive
Fervidobacterium pennivorans	Thermotogae	negative
Symbiobacterium toebii	Firmicutes	negative
Aggregatibacter aphrophilus	Gammaproteobacteria	negative
Rickettsia africae	Alphaproteobacteria	negative
Rickettsia endosymbiont	Alphaproteobacteria	negative
Xenorhabdus nematophila	Gammaproteobacteria	negative
Bacillus lentus	Firmicutes	positive
Enterococcus gallinarum	Firmicutes	positive
Bartonella clarridgeiae	Alphaproteobacteria	negative
Hydrogenobaculum sp.	Aquificae	negative
Serratia sp.	Gammaproteobacteria	negative
Clostridium ljungdahlii	Firmicutes	positive
Photobacterium profundum	Gammaproteobacteria	negative
Rhodoferax ferrireducens	Betaproteobacteria	negative
Mycobacterium marinum	Actinobacteria	positive
Flavobacterium johnsoniae	Bacteroidetes/Chlorobi	negative
Escherichia fergusonii	Gammaproteobacteria	negative
Collinsella sp.	Actinobacteria	positive
Endozoicomonas montiporae	Gammaproteobacteria	negative
Lactobacillus hilgardii	Firmicutes	positive
Gluconacetobacter oboediens	Alphaproteobacteria	negative
Staphylococcus epidermidis	Firmicutes	positive
Ruegeria sp.	Alphaproteobacteria	negative
Coriobacterium glomerans	Actinobacteria	positive
Enterobacter sp.	Gammaproteobacteria	negative
Buchnera aphidicola	Gammaproteobacteria	negative
Ammonifex degensii	Firmicutes	positive
Granulibacter bethesdensis	Alphaproteobacteria	negative
Desulfonispora thiosulfatigenes	Firmicutes	positive
Cellulophaga algicola	Bacteroidetes/Chlorobi	negative
Nocardiopsis dassonvillei	Actinobacteria	positive
Eubacterium limosum	Firmicutes	positive
Syntrophus aciditrophicus	Deltaproteobacteria	negative
Intrasporangium calvum	Actinobacteria	positive
Acidaminococcus sp.	Firmicutes	negative
Alcanivorax sp.	Gammaproteobacteria	negative
Sulfurovum sp.	Epsilonproteobacteria	negative
Paenibacillus curdlanolyticus	Firmicutes	positive
Rhodococcus aetherivorans	Actinobacteria	positive
Psychroflexus torquis	Bacteroidetes/Chlorobi	negative
Streptomyces ghanaensis	Actinobacteria	positive
Rickettsia typhi	Alphaproteobacteria	negative
Xylella fastidiosa	Gammaproteobacteria	negative
Actinomyces israelii	Actinobacteria	positive
Holdemania filiformis	Firmicutes	positive
Anabaena sp.	Cyanobacteria	negative
Afipia broomeae	Alphaproteobacteria	negative
Methylobacterium populi	Alphaproteobacteria	negative
Thiomicrospira crunogena	Gammaproteobacteria	negative
Pseudomonas	Gammaproteobacteria	negative
Shewanella oneidensis	Gammaproteobacteria	negative
Spiroplasma citri	Tenericutes	positive
Enterococcus saccharolyticus	Firmicutes	positive
Geobacter uraniireducens	Deltaproteobacteria	negative
Capnocytophaga gingivalis	Bacteroidetes/Chlorobi	negative
Dorea formicigenerans	Firmicutes	positive
Yersinia aldovae	Gammaproteobacteria	negative
Frankia alni	Actinobacteria	positive
Beutenbergia cavernae	Actinobacteria	positive
Yersinia ruckeri	Gammaproteobacteria	negative
Bacteroides salanitronis	Bacteroidetes/Chlorobi	negative
Xanthomonas arboricola	Gammaproteobacteria	negative
Stenotrophomonas maltophilia	Gammaproteobacteria	negative
Afipia felis	Alphaproteobacteria	negative
Acidovorax sp.	Betaproteobacteria	negative
Nitratifractor salsuginis	Epsilonproteobacteria	negative
Vibrio caribbenthicus	Gammaproteobacteria	negative
Subdoligranulum variabile	Firmicutes	negative
Thermosinus carboxydivorans	Firmicutes	negative
Maize bushy	Firmicutes	positive
Aerococcus christensenii	Firmicutes	positive
Vibrio fluvialis	Gammaproteobacteria	negative
Prevotella buccalis	Bacteroidetes/Chlorobi	negative
Anaerococcus prevotii	Firmicutes	positive
Campylobacter volucris	Epsilonproteobacteria	negative
Thermoanaerobacter ethanolicus	Firmicutes	positive
Clavibacter michiganensis	Actinobacteria	positive
Corynebacterium aurimucosum	Actinobacteria	positive
Streptococcus constellatus	Firmicutes	positive
Desulfovibrio piger	Deltaproteobacteria	negative
Geobacter bemidjiensis	Deltaproteobacteria	negative
Desulfonatronospira thiodismutans	Deltaproteobacteria	negative
Streptococcus equinus	Firmicutes	positive
Dialister micraerophilus	Firmicutes	negative
Brevibacillus laterosporus	Firmicutes	positive
Halanaerobium hydrogeniformans	Firmicutes	positive
Staphylococcus haemolyticus	Firmicutes	positive
Dechlorosoma suillum	Betaproteobacteria	negative
Spiroplasma melliferum	Tenericutes	positive
Saccharomonospora viridis	Actinobacteria	negative
Maritimibacter alkaliphilus	Alphaproteobacteria	negative
Porphyromonas catoniae	Bacteroidetes/Chlorobi	negative
Acidovorax delafieldii	Betaproteobacteria	negative
Clostridium alkalicellulosi	Firmicutes	positive
Shewanella denitrificans	Gammaproteobacteria	negative
Lactobacillus mali	Firmicutes	positive
Marinovum algicola	Alphaproteobacteria	negative
Streptococcus salivarius	Firmicutes	positive
Parvimonas sp.	Firmicutes	positive
Magnetospirillum magnetotacticum	Alphaproteobacteria	negative
Alteromonadales bacterium	Gammaproteobacteria	negative
Cellulophaga lytica	Bacteroidetes/Chlorobi	negative
Burkholderia cepacia	Betaproteobacteria	negative
Capnocytophaga sp.	Bacteroidetes/Chlorobi	negative
Yersinia intermedia	Gammaproteobacteria	negative
Nitrobacter hamburgensis	Alphaproteobacteria	negative
Lactococcus garvieae	Firmicutes	positive
Legionella hackeliae	Gammaproteobacteria	negative
Oleispira antarctica	Gammaproteobacteria	negative
Epulopiscium sp.	Firmicutes	positive
Sporosarcina newyorkensis	Firmicutes	positive
Scytonema hofmanni	Cyanobacteria	negative
Acidaminococcus fermentans	Firmicutes	negative
Haliangium ochraceum	Deltaproteobacteria	negative
Helicobacter pullorum	Epsilonproteobacteria	negative
Prevotella bergensis	Bacteroidetes/Chlorobi	negative
Porphyromonas endodontalis	Bacteroidetes/Chlorobi	negative
Acidiphilium sp.	Alphaproteobacteria	negative
Brucella melitensis	Alphaproteobacteria	negative
Rubrobacter radiotolerans	Actinobacteria	positive
Shigella sp.	Gammaproteobacteria	negative
Arthrobacter chlorophenolicus	Actinobacteria	positive
Acinetobacter bereziniae	Gammaproteobacteria	negative
Flavobacteriales bacterium	Bacteroidetes/Chlorobi	negative
Roseburia sp.	Firmicutes	positive
Acinetobacter parvus	Gammaproteobacteria	negative
Sphingobium japonicum	Alphaproteobacteria	negative
Rubrivivax benzoatilyticus	Betaproteobacteria	negative
Leuconostoc carnosum	Firmicutes	positive
Prochlorococcus marinus	Cyanobacteria	negative
Borrelia bissettii	Spirochaetes	negative
Corynebacterium tuberculostearicum	Actinobacteria	positive
Acinetobacter lwoffii	Gammaproteobacteria	negative
Bizionia argentinensis	Bacteroidetes/Chlorobi	negative
Thiothrix nivea	Gammaproteobacteria	negative
Clostridium colicanis	Firmicutes	positive
Desulfovibrio salexigens	Deltaproteobacteria	negative
Polynucleobacter necessarius	Betaproteobacteria	negative
Shewanella loihica	Gammaproteobacteria	negative
Erwinia sp.	Gammaproteobacteria	negative
Laribacter hongkongensis	Betaproteobacteria	negative
Echinicola vietnamensis	Bacteroidetes/Chlorobi	negative
Treponema saccharophilum	Spirochaetes	negative
Clostridium scindens	Firmicutes	positive
Nakamurella multipartita	Actinobacteria	positive
Spirochaeta caldaria	Spirochaetes	negative
Thermosipho africanus	Thermotogae	negative
Prevotella timonensis	Bacteroidetes/Chlorobi	negative
Leptospira biflexa	Spirochaetes	negative
Thermincola potens	Firmicutes	positive
Chlamydophila pecorum	Chlamydiae/Verrucomicrobia	negative
Ochrobactrum intermedium	Alphaproteobacteria	negative
Mesoflavibacter zeaxanthinifaciens	Bacteroidetes/Chlorobi	negative
Cellulomonas fimi	Actinobacteria	positive
Xanthobacter autotrophicus	Alphaproteobacteria	negative
Paracoccus sp.	Alphaproteobacteria	negative
Dickeya dadantii	Gammaproteobacteria	negative
Microlunatus phosphovorus	Actinobacteria	positive
Megasphaera genomosp.	Firmicutes	negative
Streptococcus gordonii	Firmicutes	positive
Peptostreptococcus stomatis	Firmicutes	positive
Acidithiobacillus caldus	Gammaproteobacteria	negative
Reinekea blandensis	Gammaproteobacteria	negative
Xanthomonas fuscans	Gammaproteobacteria	negative
Alkaliphilus oremlandii	Firmicutes	positive
Clostridium ultunense	Firmicutes	positive
Dyadobacter fermentans	Bacteroidetes/Chlorobi	negative
Haemophilus parasuis	Gammaproteobacteria	negative
Lactobacillus iners	Firmicutes	positive
Lactobacillus brevis	Firmicutes	positive
Chloroflexus sp.	Chloroflexi	negative
Providencia rettgeri	Gammaproteobacteria	negative
Sulfurimonas denitrificans	Epsilonproteobacteria	negative
Labrenzia sp.	Alphaproteobacteria	negative
Campylobacterales bacterium	Epsilonproteobacteria	negative
Sphingomonas sp.	Alphaproteobacteria	negative
Bacteroides helcogenes	Bacteroidetes/Chlorobi	negative
Mycoplasma pulmonis	Firmicutes	negative
Bacteroides oleiciplenus	Bacteroidetes/Chlorobi	negative
Methylobacterium mesophilicum	Alphaproteobacteria	negative
Leptonema illini	Spirochaetes	negative
Zunongwangia profunda	Bacteroidetes/Chlorobi	negative
Tannerella forsythia	Bacteroidetes/Chlorobi	negative
Cytophaga fermentans	Bacteroidetes/Chlorobi	negative
Bacteroidales bacterium	Bacteroidetes/Chlorobi	negative
Listeria seeligeri	Firmicutes	positive
Granulicatella adiacens	Firmicutes	positive
Erwinia aphidicola	Gammaproteobacteria	negative
Leptolyngbya valderiana	Cyanobacteria	negative
Aeromonas hydrophila	Gammaproteobacteria	negative
Anaeromyxobacter sp.	Deltaproteobacteria	negative
Streptococcus downei	Firmicutes	positive
Gemella moribillum	Firmicutes	positive
Amycolatopsis mediterranei	Actinobacteria	positive
Listeria grayi	Firmicutes	positive
Corynebacterium durum	Actinobacteria	positive
Thiovulum majus	Epsilonproteobacteria	negative
Moorella thermoacetica	Firmicutes	positive
Grimontia hollisae	Gammaproteobacteria	negative
Listeria monocytogenes	Firmicutes	positive
Campylobacter showae	Epsilonproteobacteria	negative
Brachyspira murdochii	Spirochaetes	negative
Vibrio metschnikovii	Gammaproteobacteria	negative
Methylophaga aminisulfidivorans	Gammaproteobacteria	negative
Neisseria polysaccharea	Betaproteobacteria	negative
Bartonella henselae	Alphaproteobacteria	negative
Rhodococcus opacus	Actinobacteria	positive
Clostridium sp.	Firmicutes	positive
Raphidiopsis brookii	Cyanobacteria	negative
Nautilia profundicola	Epsilonproteobacteria	negative
Melissococcus plutonius	Firmicutes	positive
Burkholderia plantarii	Betaproteobacteria	negative
Octadecabacter antarcticus	Alphaproteobacteria	negative
Polaribacter filamentus	Bacteroidetes/Chlorobi	negative
Streptomyces albus	Actinobacteria	positive
Alistipes shahii	Bacteroidetes/Chlorobi	negative
Streptococcus anginosus	Firmicutes	positive
Bradyrhizobium japonicum	Alphaproteobacteria	negative
Halorhodospira halophila	Gammaproteobacteria	negative
Pedobacter saltans	Bacteroidetes/Chlorobi	negative
Mycobacterium smegmatis	Actinobacteria	positive
Marinobacter algicola	Gammaproteobacteria	negative
Erysipelothrix rhusiopathiae	Firmicutes	positive
Thioalkalivibrio thiocyanoxidans	Gammaproteobacteria	negative
Bifidobacterium pseudocatenulatum	Actinobacteria	positive
Tolypothrix sp.	Cyanobacteria	negative
Capnocytophaga sputigena	Bacteroidetes/Chlorobi	negative
Bifidobacterium sp.	Actinobacteria	positive
Prevotella oris	Bacteroidetes/Chlorobi	negative
Flavobacterium branchiophilum	Bacteroidetes/Chlorobi	negative
Algoriphagus sp.	Bacteroidetes/Chlorobi	negative
Neisseria cinerea	Betaproteobacteria	negative
Aeromicrobium sp.	Actinobacteria	positive
Meiothermus ruber	Deinococcus-Thermus	negative
Porphyromonas asaccharolytica	Bacteroidetes/Chlorobi	negative
Deinococcus deserti	Deinococcus-Thermus	negative
Acaryochloris sp.	Cyanobacteria	negative
Anaplasma marginale	Alphaproteobacteria	negative
Staphylococcus pseudintermedius	Firmicutes	positive
Streptococcus mutans	Firmicutes	positive
Mycoplasma crocodyli	Firmicutes	negative
Photorhabdus asymbiotica	Gammaproteobacteria	negative
Lactobacillus buchneri	Firmicutes	positive
Oribacterium sinus	Firmicutes	positive
Bacillus pseudomycoides	Firmicutes	positive
Clostridium butyricum	Firmicutes	positive
Bdellovibrio bacteriovorus	Deltaproteobacteria	negative
Mesorhizobium australicum	Alphaproteobacteria	negative
Jiangella gansuensis	Actinobacteria	positive
Escherichia albertii	Gammaproteobacteria	negative
Eggerthella sp.	Actinobacteria	positive
Megamonas hypermegale	Firmicutes	negative
Acinetobacter radioresistens	Gammaproteobacteria	negative
Rhodospirillum rubrum	Alphaproteobacteria	negative
Paludibacter propionicigenes	Bacteroidetes/Chlorobi	negative
