Salmonella phage MA12	negative
Salmonella phage 118970_sal2	negative
Gordonia phage GAL1	positive
Streptococcus phage phiARI0468-4	positive
Streptococcus phage phiARI0746	positive
Salmonella phage IME207	negative
Salmonella phage 118970_sal1	negative
Salmonella phage 100268_sal2	negative
Salmonella phage BPS11Q3	negative
Staphylococcus phage CNPx	positive
Mycobacterium phage Catalina	myco
Arthrobacter phage KellEzio	positive
Arthrobacter phage Kitkat	positive
Mycobacterium phage Bipper	myco
Mycobacterium phage Mulciber	myco
Mycobacterium phage Brocalys	myco
Mycobacterium phage Loser	myco
Mycobacterium phage ArcherNM	myco
Mycobacterium phage Panchino	myco
Mycobacterium phage Xeno	myco
Mycobacterium phage Phrann	myco
Gordonia phage BetterKatz	positive
Gordonia phage Emalyn	positive
Gordonia phage Guacamole	positive
Gordonia phage Hotorobo	positive
Gordonia phage Kita	positive
Gordonia phage Lucky10	positive
Gordonia phage Obliviate	positive
Gordonia phage Schwabeltier	positive
Gordonia phage SoilAssassin	positive
Gordonia phage UmaThurman	positive
Gordonia phage Vivi2	positive
Gordonia phage Yeezy	positive
Gordonia phage Yvonnetastic	positive
Mycobacterium phage EvilGenius	myco
Mycobacterium phage Shipwreck	myco
Salmonella phage BP12C	negative
Enterococcus phage Ec-ZZ2	positive
Mycobacterium phage Bactobuster	myco
Arthrobacter phage Mudcat	positive
Gordonia phage BaxterFox	positive
Gordonia phage Utz	positive
Gordonia phage GMA1	positive
Tsukamurella phage TPA4	positive
Pseudomonas phage JBD44	negative
Pseudomonas phage YMC11/07/P54_PAE_BP	negative
Gordonia phage Blueberry	positive
Gordonia phage Cozz	positive
Gordonia phage Monty	positive
Pseudomonas phage phi2	negative
Gordonia phage Woes	positive
Gordonia phage GMA6	positive
Gordonia phage GRU3	positive
Gordonia phage Bachita	positive
Gordonia phage ClubL	positive
Gordonia phage McGonagall	positive
Gordonia phage Splinter	positive
Gordonia phage Wizard	positive
Gordonia phage Gsput1	positive
Gordonia phage GMA5	positive
Bacillus phage vB_BhaS-171	positive
Pseudomonas phage JBD93	negative
Gordonia phage BritBrat	positive
Gordonia phage Kvothe	positive
Gordonia phage Orchid	positive
Gordonia phage Vendetta	positive
Gordonia phage GMA4	positive
Streptococcus phage phiARI0923	positive
Pseudomonas phage JBD69	negative
Gordonia phage Bowser	positive
Gordonia phage Demosthenes	positive
Gordonia phage OneUp	positive
Pseudomonas phage MD8	negative
Bacillus phage PfEFR-5	positive
Enterococcus phage SANTOR1	positive
Escherichia phage Envy	negative
Escherichia phage Gluttony	negative
Gordonia phage Terapin	positive
Gordonia phage Twister6	positive
Gordonia phage Zirinka	positive
Mycobacterium phage Gengar	myco
Salmonella phage phSE-2	negative
Weissella phage WCP30	positive
Pseudomonas phage NP1	negative
Lactococcus phage D4410	positive
Lactococcus phage D4412	positive
Lactococcus phage M5938	positive
Lactococcus phage M6162	positive
Lactococcus phage M6165	positive
Mycobacterium phage Makemake	myco
Mycobacterium phage Papez	myco
Mycobacterium phage Gompeii16	myco
Lactococcus phage PLgT-1	positive
Gordonia phage Nymphadora	positive
Gordonia phage Phinally	positive
Enterobacteria phage vB_EcoS_NBD2	negative
Acinetobacter phage vB_AbaS_TRS1	negative
Lactococcus phage 28201	positive
Lactococcus phage 50101	positive
Lactococcus phage 63301	positive
Lactococcus phage 98201	positive
Rhodovulum phage vB_RhkS_P1	negative
Mycobacterium phage Gardann	myco
Streptomyces phage Nanodon	positive
Mycobacterium phage Sneeze	myco
Propionibacterium phage BruceLethal	positive
Propionibacterium phage Enoki	positive
Propionibacterium phage Moyashi	positive
Propionibacterium phage QueenBey	positive
Klebsiella phage PKP126	negative
Streptococcus virus 9871	positive
Streptococcus virus 9872	positive
Streptococcus virus 9874	positive
Gordonia phage Bantam	positive
Gordonia phage CaptainKirk2	positive
Gordonia phage CarolAnn	positive
Gordonia phage Cucurbita	positive
Gordonia phage Eyre	positive
Gordonia phage Ghobes	positive
Gordonia phage Hedwig	positive
Gordonia phage JSwag	positive
Gordonia phage Jumbo	positive
Gordonia phage Nyceirae	positive
Gordonia phage Remus	positive
Lactobacillus phage PLE3	positive
Lactobacillus phage PLE2	positive
Gordonia phage KatherineG	positive
Gordonia phage Rosalind	positive
Gordonia phage Smoothie	positive
Gordonia phage Soups	positive
Staphylococcus phage 80	positive
Mycobacterium phage Edtherson	myco
Paenibacillus phage Rani	positive
Lactobacillus phage LfeSau	positive
Achromobacter phage JWF	negative
Salmonella phage 36	negative
Staphylococcus phage SPbeta-like	positive
Erysipelothrix phage SE-1	positive
Achromobacter phage phiAxp-2	negative
Mycobacterium phage VohminGhazi	myco
Gordonia phage GordDuk1	positive
Mycobacterium phage Mindy	myco
Pseudomonas phage PS-1	negative
Lactococcus phage GE1	positive
Streptomyces phage Jay2Jay	positive
Geobacillus virus E3	positive
Gordonia phage GordTnk2	positive
Mycobacterium phage Dusk	myco
Pseudoalteromonas phage Pq0	negative
Sinorhizobium phage phiLM21	negative
Verrucomicrobia phage P8625	negative
Salmonella phage 37	negative
Mycobacterium phage SweetiePie	myco
Escherichia phage slur09	negative
Achromobacter phage phiAxp-1	negative
Clostridium phage phiCD111	positive
Clostridium phage phiCD146	positive
Lactococcus phage CB13	positive
Lactococcus phage CB14	positive
Mycobacterium phage Carcharodon	myco
Mycobacterium phage CaptainTrips	myco
Mycobacterium phage Larenn	myco
Mycobacterium phage Murucutumbu	myco
Mycobacterium phage MiaZeal	myco
Proteus phage pPM_01	negative
Mannheimia phage vB_MhS_535AP2	negative
Mannheimia phage vB_MhS_1152AP2	negative
Mycobacterium phage Phipps	myco
Mycobacterium phage Vortex	myco
Mycobacterium phage Toto	myco
Mycobacterium phage Kikipoo	myco
Lactococcus phage ASCC191	positive
Pseudomonas phage PaMx11	negative
Pseudomonas phage PaMx28	negative
Pseudomonas phage PaMx42	negative
Pseudomonas phage PaMx74	negative
Mycobacterium phage Anubis	myco
Mycobacterium phage Swirley	myco
Mycobacterium phage Piro94	myco
Mycobacterium phage Cheetobro	myco
Staphylococcus phage SA97	positive
Mycobacterium phage MarQuardt	myco
Mycobacterium phage Sheen	myco
Vibrio phage phi 3	negative
Achromobacter phage JWX	negative
Achromobacter phage 83-24	negative
Paenibacillus phage HB10c2	positive
Paenibacillus phage Diva	positive
Bacteriophage Lily	positive
Paenibacillus phage Sitara	positive
Listeria phage vB_LmoS_188	positive
Listeria phage vB_LmoS_293	positive
Mycobacterium phage Kratio	myco
Klebsiella phage 1513	negative
Propionibacterium phage PAC1	positive
Streptomyces phage SF1	positive
Streptomyces phage SF3	positive
Brevibacillus phage Jenst	positive
Mycobacterium phage BrownCNA	myco
Mycobacterium phage Phatniss	myco
Mycobacterium phage Dante	myco
Mycobacterium phage Chadwick	myco
Mycobacterium phage Pioneer	myco
Mycobacterium phage Tasp14	myco
Mycobacterium phage Rufus	myco
Mycobacterium phage Enkosi	myco
Mycobacterium phage Lolly9	myco
Mycobacterium phage PopTart	myco
Mycobacterium phage Seagreen	myco
Mycobacterium phage Snenia	myco
Mycobacterium phage XFactor	myco
Mycobacterium phage TheloniousMonk	myco
Mycobacterium phage Turj99	myco
Mycobacterium phage Serenity	myco
Enterococcus phage IME-EFm5	positive
Paenibacillus phage Tripp	positive
Mycobacterium phage Pari	myco
Mycobacterium phage Theia	myco
Pseudomonas phage PAE1	negative
Mycobacterium phage Archie	myco
Mycobacterium phage Mufasa	myco
Staphylococcus phage StB20-like	positive
Lactobacillus phage CL1	positive
Lactobacillus phage CL2	positive
Lactobacillus phage iA2	positive
Lactobacillus phage iLp84	positive
Lactobacillus phage iLp1308	positive
Mycobacterium phage OSmaximus	myco
Staphylococcus phage 3MRA	positive
Staphylococcus phage 23MRA	positive
Streptococcus phage M102AD	positive
Escherichia phage CAjan	negative
Enterobacteria phage JenK1	negative
Enterobacteria phage JenP1	negative
Enterobacteria phage JenP2	negative
Staphylococcus phage B166	positive
Staphylococcus phage B236	positive
Stenotrophomonas phage vB_SmaS-DLP	negative
Staphylococcus phage vB_SauS_phi2	positive
Mycobacterium phage Barriga	myco
Mycobacterium phage Florinda	myco
Mycobacterium phage Nhonho	myco
Escherichia phage slur01	negative
Escherichia phage slur05	negative
Enterococcus phage vB_EfaS_IME198	positive
Enterococcus phage vB_EfaS_IME196	positive
Streptomyces phage phiSAJS1	positive
Lactococcus phage SL4	positive
Staphylococcus phage phinm2	positive
Staphylococcus phage phinm4	positive
Bacillus virus 250	positive
Staphylococcus phage IME-SA4	positive
Gordonia phage Gmala1	positive
Streptomyces phage YDN12	positive
Streptomyces phage TP1604	positive
Paenibacillus phage Fern	positive
Paenibacillus phage Vegas	positive
Paenibacillus phage Xenia	positive
Tsukamurella phage TIN2	positive
Tsukamurella phage TIN3	positive
Mycobacterium phage Luchador	myco
Mycobacterium phage Vincenzo	myco
Mycobacterium phage Phayonce	myco
Mycobacterium phage FlagStaff	myco
Mycobacterium phage Cambiare	myco
Mycobacterium phage Nerujay	myco
Mycobacterium phage MOOREtheMARYer	myco
Mycobacterium phage ShedlockHolmes	myco
Polaribacter phage P12002L	negative
Polaribacter phage P12002S	negative
Streptococcus phage APCM01	positive
Klebsiella phage KLPN1	negative
Mycobacterium phage Kimberlium	myco
Mycobacterium phage Smeadley	myco
Mycobacterium phage UnionJack	myco
Streptomyces phage Amela	positive
Mycobacterium phage Ovechkin	myco
Streptomyces phage Izzy	positive
Streptomyces phage Lannister	positive
Klebsiella phage Sushi	negative
Mycobacterium phage NelitzaMV	myco
Streptomyces phage Caliburn	positive
Mycobacterium phage Tiffany	myco
Mycobacterium phage Omnicron	myco
Mycobacterium phage Llama	myco
Mycobacterium phage Ariel	myco
Mycobacterium phage Abrogate	myco
Mycobacterium phage Bipolar	myco
Mycobacterium phage Equemioh13	myco
Brevibacillus phage Sundance	positive
Mycobacterium phage Brusacoram	myco
Bacillus phage vB_BtS_BMBtp3	positive
Salmonella phage Shivani	negative
Mycobacterium phage Quico	myco
Paenibacillus phage Harrison	positive
Mycobacterium phage Baee	myco
Mannheimia phage vB_MhS_587AP2	negative
Mycobacterium phage LadyBird	myco
Enterobacter phage phiEap-2	negative
Mycobacterium phage Iracema64	myco
Mycobacterium phage Colbert	myco
Propionibacterium phage PA1-14	positive
Staphylococcus phage phiJB	positive
Rhodococcus phage CosmicSans	positive
Mycobacterium phage Pops	myco
Mycobacterium phage Swish	myco
Mycobacterium phage Sparkdehlily	myco
Pseudomonas phage vB_PaeS_PM105	negative
Mycobacterium phage Eremos	myco
Arthrobacter phage Decurro	positive
Mycobacterium phage Cabrinians	myco
Mycobacterium phage ShiVal	myco
Salmonella phage f18SE	negative
Pseudomonas phage YMC11/02/R656	negative
Mycobacterium phage Badfish	myco
Mycobacterium phage Apizium	myco
Mycobacterium phage Pepe	myco
Enterococcus phage vB_EfaS_IME197	positive
Leuconostoc phage 1-A4	positive
Escherichia phage K1-dep(4)	negative
Mycobacterium phage UncleHowie	myco
Escherichia phage K1-dep(1)	negative
Lactobacillus phage phiPYB5	positive
Propionibacterium phage SKKY	positive
Propionibacterium phage Solid	positive
Propionibacterium phage Stormborn	positive
Propionibacterium phage Wizzo	positive
Propionibacterium phage Attacne	positive
Propionibacterium phage Kubed	positive
Propionibacterium phage Lauchelly	positive
Propionibacterium phage MrAK	positive
Propionibacterium phage Ouroboros	positive
Propionibacterium phage Pirate	positive
Propionibacterium phage Procrass1	positive
Propionibacterium phage PHL009	positive
Propionibacterium phage PHL025	positive
Propionibacterium phage PHL030	positive
Propionibacterium phage PHL041	positive
Propionibacterium phage PHL055	positive
Propionibacterium phage PHL070	positive
Propionibacterium phage PHL082	positive
Propionibacterium phage PHL085	positive
Propionibacterium phage PHL092	positive
Propionibacterium phage PHL095	positive
Propionibacterium phage PHL116	positive
Propionibacterium phage PHL132	positive
Propionibacterium phage PHL141	positive
Propionibacterium phage PHL152	positive
Propionibacterium phage PHL171	positive
Propionibacterium phage PHL179	positive
Propionibacterium phage PHL301	positive
Mycobacterium phage fionn	myco
Pseudomonas phage H70	negative
Leuconostoc phage Ln-8	positive
Leuconostoc phage Ln-9	positive
Citrobacter phage Stevie	negative
Lactococcus phage WRP3	positive
Streptococcus phage SpSL1	positive
Escherichia phage YD-2008.s	negative
Escherichia virus DT57C	negative
Propionibacterium phage Pacnes 2012-15	positive
Pseudomonas phage LPB1	negative
Propionibacterium phage PHL199	positive
Propionibacterium phage PHL150	positive
Enterobacteria phage phi80	negative
Lactococcus phage 1358	positive
Lactococcus phage bIBB29	positive
Lactococcus phage jj50	positive
Lactococcus phage 712	positive
Lactococcus phage P008	positive
Staphylococcus phage X2	positive
Lactococcus phage bIL170	positive
Lactococcus phage SK1	positive
Staphylococcus phage 88	positive
Staphylococcus phage 71	positive
Staphylococcus phage 52A	positive
Staphylococcus phage 53	positive
Staphylococcus phage 29	positive
Staphylococcus phage 96	positive
Staphylococcus phage 69	positive
Staphylococcus phage 92	positive
Staphylococcus phage 85	positive
Mycobacterium phage Sparky	myco
Mycobacterium phage Hades	myco
Mycobacterium phage Squirty	myco
Mycobacterium phage Minerva	myco
Mycobacterium phage Trike	myco
Mycobacterium phage Inventum	myco
Mycobacterium phage BuzzLyseyear	myco
Mycobacterium phage Estave1	myco
Lactobacillus phage Ldl1	positive
Mycobacterium phage Alvin	myco
Mycobacterium phage Keshu	myco
Mycobacterium phage Malithi	myco
Mycobacterium phage Milly	myco
Mycobacterium phage Sbash	myco
Vibrio phage VpKK5	negative
Pseudomonas phage vB_PaeS_PAO1_Ab18	negative
Pseudomonas phage vB_PaeS_PAO1_Ab30	negative
Paracoccus phage vB_PmaS_IMEP1	negative
Mycobacterium phage Gaia	myco
Mycobacterium phage Cerasum	myco
Staphylococcus phage 47	positive
Enterococcus phage VD13	positive
Helicobacter phage phiHP33	negative
Salmonella phage LSPA1	negative
Staphylococcus phage phiBU01	positive
Shigella phage pSf-2	negative
Enterococcus phage EFC-1	positive
Staphylococcus phage phiSa119	positive
Idiomarinaceae phage Phi1M2-2	negative
Mycobacterium phage Taj	myco
Enterococcus phage EfaCPT1	positive
Mycobacterium phage Soto	myco
Salmonella phage Chi	negative
Ruegeria phage DSS3-P1	negative
Mycobacterium phage RedRock	myco
Lactobacillus phage Ld17	positive
Lactobacillus phage Ld25A	positive
Lactobacillus phage Ld3	positive
Bacillus phage Waukesha92	positive
Escherichia phage vB_EcoS_AHP42	negative
Escherichia phage vB_EcoS_AKS96	negative
Enterobacteria phage EK99P-1	negative
Pseudomonas phage MP48	negative
Escherichia phage vB_EcoS_AHS24	negative
Leuconostoc phage phiLN25	positive
Leuconostoc phage phiLN03	positive
Leuconostoc phage phiLNTR2	positive
Leuconostoc phage phiLN12	positive
Listeria phage LP-101	positive
Leuconostoc phage phiLNTR3	positive
Leuconostoc phage phiLN34	positive
Leuconostoc phage phiLN6B	positive
Listeria phage LP-030-3	positive
Listeria phage LP-114	positive
Staphylococcus phage DW2	positive
Pseudomonas phage vB_PaeS_SCH_Ab26	negative
Mycobacterium phage OkiRoe	myco
Mycobacterium phage Damien	myco
Enterococcus phage IME-EFm1	positive
Mycobacterium phage Pinto	myco
Mycobacterium phage Manad	myco
Listeria phage LP-026	positive
Staphylococcus phage 6ec	positive
Pseudomonas phage phiPSA1	negative
Pseudomonas phage JD024	negative
Mycobacterium phage Hawkeye	myco
Lactococcus phage P162	positive
Lactococcus phage P118	positive
Lactococcus phage P078	positive
Lactococcus phage P092	positive
Salmonella phage vB_SenS-Ent3	negative
Escherichia phage e4/1c	negative
Mycobacterium phage Seabiscuit	myco
Mycobacterium phage Phantastic	myco
Mycobacterium phage Hosp	myco
Mycobacterium phage Bernal13	myco
Mycobacterium phage ZoeJ	myco
Mycobacterium phage Kampy	myco
Mycobacterium phage MosMoris	myco
Mycobacterium phage Lamina13	myco
Enterobacteria phage 9g	negative
Escherichia phage vB_EcoS_FFH1	negative
Mycobacterium phage Akoma	myco
Mycobacterium phage LHTSCC	myco
Mycobacterium phage DS6A	myco
Mycobacterium phage SkiPole	myco
Mycobacterium phage Stinger	myco
Mycobacterium phage GUmbie	myco
Mycobacterium phage BarrelRoll	myco
Bacillus phage Slash	positive
Microbacterium phage vB_MoxS-ISF9	positive
Mycobacterium phage Alsfro	myco
Bacillus phage vB_BanS-Tsamsa	positive
Mycobacterium phage Acadian	myco
Mycobacterium phage BillKnuckles	myco
Mycobacterium phage Courthouse	myco
Mycobacterium phage Bruns	myco
Mycobacterium phage Alma	myco
Mycobacterium phage Babsiella	myco
Mycobacterium phage DeadP	myco
Mycobacterium phage Vista	myco
Mycobacterium phage Gadjet	myco
Mycobacterium phage Dori	myco
Mycobacterium phage Kugel	myco
Mycobacterium phage Blue7	myco
Mycobacterium phage Firecracker	myco
Mycobacterium phage JacAttac	myco
Mycobacterium phage SG4	myco
Rhodococcus phage ReqiPoco6	positive
Rhodococcus phage ReqiPepy6	positive
Mycobacterium phage Aeneas	myco
Rhodococcus phage ReqiPine5	positive
Mycobacterium phage Thibault	myco
Rhodococcus phage ReqiDocB7	positive
Mycobacterium phage Doom	myco
Mycobacterium phage Charlie	myco
Mycobacterium phage Euphoria	myco
Mycobacterium phage Oline	myco
Mycobacterium phage Avani	myco
Mycobacterium phage Larva	myco
Mycobacterium phage Lilac	myco
Mycobacterium phage Trixie	myco
Mycobacterium phage RidgeCB	myco
Mycobacterium phage Wile	myco
Mycobacterium phage Turbido	myco
Mycobacterium phage Drago	myco
Mycobacterium phage Perseus	myco
Mycobacterium phage Patience	myco
Mycobacterium phage Liefie	myco
Mycobacterium phage BigNuz	myco
Mycobacterium phage Dreamboat	myco
Mycobacterium phage Redi	myco
Mycobacterium phage Rumpelstiltskin	myco
Mycobacterium phage Violet	myco
Escherichia phage EB49	negative
Pseudomonas phage PA1phi	negative
Psychrobacter phage Psymv2	negative
Clavibacter phage CN1A	positive
Mycobacterium phage Saal	myco
Mycobacterium phage Adler	myco
Mycobacterium phage KLucky39	myco
Vibrio phage SHOU24	negative
Mycobacterium phage EagleEye	myco
Mycobacterium phage JAMaL	myco
Mycobacterium phage MichelleMyBell	myco
Staphylococcus phage vB_SepS_SEP9	positive
Enterococcus phage IME-EF4	positive
Mycobacterium phage Echild	myco
Mycobacterium phage Oaker	myco
Acinetobacter phage IME_AB3	negative
Mycobacterium phage Nyxis	myco
Mycobacterium phage Eagle	myco
Bacillus phage phiCM3	positive
Mycobacterium phage CRB1	myco
Mycobacterium phage Donovan	myco
Croceibacter phage P2559Y	negative
Mycobacterium phage 20ES	myco
Rhizobium phage vB_RglS_P106B	negative
Mycobacterium phage 32HC	myco
Mycobacterium phage RhynO	myco
Mycobacterium phage Jolie2	myco
Geobacillus phage GBK2	positive
Mycobacterium phage 40AC	myco
Mycobacterium phage 39HC	myco
Mycobacterium phage Jolie1	myco
Salmonella phage vB_SenS-Ent2	negative
Erwinia phage PhiEaH1	negative
Enterococcus phage IME_EF3	positive
Rhizobium phage vB_RleS_L338C	negative
Mycobacterium phage Validus	myco
Staphylococcus phage StauST398-4	positive
Staphylococcus phage StauST398-5	positive
Mycobacterium phage Nala	myco
Mycobacterium phage Bruin	myco
Mycobacterium phage Conspiracy	myco
Mycobacterium phage Graduation	myco
Mycobacterium phage Artemis2UCLA	myco
Mycobacterium phage PhatBacter	myco
Arthrobacter phage vB_ArS-ArV2	positive
Mycobacterium phage Zaka	myco
Mycobacterium phage CloudWang3	myco
Mycobacterium phage Bernardo	myco
Mycobacterium phage HanShotFirst	myco
Mycobacterium phage Jovo	myco
Mycobacterium phage HufflyPuff	myco
Lactobacillus phage LLKu	positive
Staphylococcus phage phiRS7	positive
Lactobacillus phage phiJB	positive
Bacillus virus Blastoid	positive
Bacillus phage Staley	positive
Bacillus virus Riggi	positive
Bacillus virus Glittering	positive
Lactobacillus phage phiLdb	positive
Streptococcus phage TP-778L	positive
Lactobacillus phage PL-1	positive
Mycobacterium phage Fredward	myco
Lactobacillus phage J-1	positive
Staphylococcus phage YMC/09/04/R1988	positive
Salmonella phage SETP13	negative
Salmonella phage SETP7	negative
Lactococcus phage phiL47	positive
Mycobacterium phage Adawi	myco
Mycobacterium phage Bane1	myco
Propionibacterium phage PHL067M10	positive
Propionibacterium phage PHL113M01	positive
Mycobacterium phage Sarfire	myco
Propionibacterium phage PHL060L00	positive
Mycobacterium phage Dylan	myco
Propionibacterium phage PHL010M04	positive
Mycobacterium phage PhrostyMug	myco
Mycobacterium phage Quink	myco
Propionibacterium phage PHL114L00	positive
Propionibacterium phage PHL111M01	positive
Propionibacterium phage PHL112N00	positive
Propionibacterium phage PHL071N05	positive
Mycobacterium phage Goku	myco
Mycobacterium phage LittleCherry	myco
Mycobacterium phage AnnaL29	myco
Mycobacterium phage Redno2	myco
Mycobacterium phage Wanda	myco
Mycobacterium phage Contagion	myco
Mycobacterium phage KayaCho	myco
Mycobacterium phage DrDrey	myco
Mycobacterium phage Bobi	myco
Mycobacterium phage Catdawg	myco
Mycobacterium phage Velveteen	myco
Mycobacterium phage Daenerys	myco
Mycobacterium phage Muddy	myco
Mycobacterium phage Trouble	myco
Mycobacterium phage Whirlwind	myco
Mycobacterium phage Hamulus	myco
Mycobacterium phage Jabbawokkie	myco
Mycobacterium phage Crossroads	myco
Mycobacterium phage Phelemich	myco
Mycobacterium phage Wheeler	myco
Mycobacterium phage Adzzy	myco
Mycobacterium phage Papyrus	myco
Lactococcus phage phi7	positive
Lactococcus phage 340	positive
Lactococcus phage P680	positive
Staphylococcus phage SA13	positive
Lactococcus phage BM13	positive
Lactococcus phage jm3	positive
Lactococcus phage jm2	positive
Cellulophaga phage phi10:1	negative
Listeria phage LP-110	positive
Cellulophaga phage phi12:1	negative
Cellulophaga phage phi17:1	negative
Cellulophaga phage phi46:1	negative
Cellulophaga phage phi18:1	negative
Cellulophaga phage phi39:1	negative
Staphylococcus phage SA12	positive
Salmonella phage iEPS5	negative
Listeria phage LP-037	positive
Cellulophaga phage phi19:1	negative
Salmonella phage FSLSP030	negative
Salmonella phage FSL SP-031	negative
Salmonella phage Jersey	negative
Salmonella phage FSLSP088	negative
Staphylococcus phage JS01	positive
Serratia phage Eta	negative
Mycobacterium phage Leo	myco
Listeria phage LP-030-2	positive
Mycobacterium phage BTCU-1	myco
Mycobacterium phage Jobu08	myco
Mycobacterium phage Job42	myco
Staphylococcus phage StauST398-2	positive
Clostridium phage vB_CpeS-CP51	positive
Shigella phage pSf-1	negative
Mycobacterium phage CASbig	myco
Mycobacterium phage WIVsmall	myco
Streptomyces phage Zemlya	positive
Mycobacterium phage Chy4	myco
Mycobacterium phage Chy5	myco
Staphylococcus phage StauST398-1	positive
Staphylococcus phage StauST398-3	positive
Salmonella phage L13	negative
Mycobacterium phage PegLeg	myco
Streptomyces phage Lika	positive
Streptomyces phage Sujidade	positive
Mycobacterium phage Dumbo	myco
Mycobacterium phage Fishburne	myco
Mycobacterium phage Newman	myco
Mycobacterium phage HINdeR	myco
Mycobacterium phage PattyP	myco
Mycobacterium phage Phrux	myco
Mycobacterium phage Severus	myco
Mycobacterium phage SiSi	myco
Mycobacterium phage Phaux	myco
Mycobacterium phage Murphy	myco
Streptococcus phage SPQS1	positive
Mycobacterium phage Butters	myco
Mycobacterium phage vB_MapS_FF47	myco
Bacillus phage PM1	positive
Leuconostoc phage P793	positive
Leuconostoc phage phiLN04	positive
Mycobacterium phage First	myco
Staphylococcus phage StB12	positive
Bacillus virus Finn	positive
Bacillus virus Eoghan	positive
Bacillus virus Curly	positive
Bacillus virus Andromeda	positive
Staphylococcus phage phi7401PVL	positive
Pseudomonas phage JBD88a	negative
Pseudomonas phage JBD5	negative
Pseudomonas phage JBD30	negative
Pseudomonas phage JBD24	negative
Streptococcus phage TP-J34	positive
Cronobacter phage ENT39118	negative
Staphylococcus phage phi5967PVL	positive
Xanthomonas phage CP1	negative
Staphylococcus phage StB27	positive
Staphylococcus phage StB20	positive
Erwinia phage phiEaH2	negative
Bacillus virus BMBtp2	positive
Lactobacillus phage ATCC8014	positive
Clostridium phage phi8074-B1	positive
Klebsiella phage KP36	negative
Enterobacteria phage HK544	negative
Enterobacteria phage HK542	negative
Enterobacteria phage HK106	negative
Vibrio phage vB_VpaS_MAR10	negative
Escherichia phage ADB-2	negative
Enterobacterial phage mEp390	negative
Enterobacterial phage mEp234	negative
Enterobacterial phage mEp213	negative
Enterobacteria phage vB_EcoS_Rogue1	negative
Enterobacteria phage mEpX2	negative
Enterobacteria phage mEpX1	negative
Enterobacteria phage mEp460	negative
Enterobacteria phage mEp237	negative
Enterobacteria phage mEp235	negative
Enterobacteria phage mEp043 c-1	negative
Enterobacteria phage HK629	negative
Enterobacteria phage HK633	negative
Enterobacteria phage HK630	negative
Enterobacteria phage HK446	negative
Enterobacteria phage HK225	negative
Enterobacteria phage HK140	negative
Escherichia phage HK578	negative
Salmonella phage Ent1	negative
Salmonella phage SPN3UB	negative
Clostridium phage phiCP26F	positive
Staphylococcus phage SMSAP5	positive
Enterobacter phage Enc34	negative
Cronobacter virus ESP29491	negative
Vibrio phage pVp-1	negative
Bacillus phage phIS3501	positive
Clostridium phage phiCP34O	positive
Clostridium phage phiCP13O	positive
Lactobacillus phage Sha1	positive
Lactobacillus phage LF1	positive
Riemerella phage RAP44	negative
Lactobacillus phage c5	positive
Lactobacillus phage JCL1032	positive
Yersinia phage phiR201	negative
Escherichia virus JL1	negative
Streptococcus phage phiNJ2	positive
Caulobacter virus Swift	negative
Caulobacter virus Rogue	negative
Caulobacter virus Magneto	negative
Caulobacter virus Karma	negative
Caulobacter phage CcrColossus	negative
Caulobacter virus phiCbK	negative
Escherichia phage vB_Eco_ACG-M12	negative
Salmonella phage SPN19	negative
Streptomyces phage R4	positive
Propionibacterium phage ATCC29399B_C	positive
Propionibacterium phage ATCC29399B_T	positive
Propionibacterium phage P1.1	positive
Propionibacterium phage P100_1	positive
Propionibacterium phage P100_A	positive
Propionibacterium phage P100D	positive
Propionibacterium phage P105	positive
Propionibacterium phage P104A	positive
Propionibacterium phage P101A	positive
Propionibacterium phage P14.4	positive
Propionibacterium phage P9.1	positive
Listeria phage P70	positive
Pectobacterium phage My1	negative
Streptomyce phage TG1	positive
Streptomyces phage SV1	positive
Streptomyces phage phiHau3	positive
Salmonella phage SSU5	negative
Cronobacter phage phiES15	negative
Pseudomonas phage MP1412	negative
Staphylococcus phage Ipla7	positive
Staphylococcus phage Ipla5	positive
Croceibacter phage P2559S	negative
Salmonella phage vB_SosS_Oslo	negative
Leuconostoc phage Lmd1	positive
Pseudomonas phage MP42	negative
Burkholderia phage AH2	negative
Burkholderia phage KL1	negative
Staphylococcus phage SpaA1	positive
Bacillus phage BtCS33	positive
Enterococcus phage BC611	positive
Clostridium phage PhiS63	positive
Mycobacterium phage SWU1	myco
Staphylococcus phage TEM123	positive
Escherichia virus AKFV33	negative
Bacillus phage PBC1	positive
Pseudomonas phage vB_Pae-Kakheti25	negative
Bacteroides phage B124-14	negative
Pseudomonas phage PMG1	negative
Salmonella phage SE2	negative
Pseudomonas phage phi297	negative
Rhodococcus phage REQ1	positive
Rhodococcus phage RER2	positive
Rhodococcus phage REQ2	positive
Rhodococcus phage RRH1	positive
Rhodococcus phage RGL3	positive
Nocardia phage NBR1	positive
Shigella phage EP23	negative
Gordonia phage GTE5	positive
Gordonia phage GRU1	positive
Gordonia phage GTE7	positive
Rhodobacter phage RcapMu	negative
Synechococcus phage S-CBS1	negative
Pediococcus phage clP1	positive
Escherichia phage HK75	negative
Escherichia phage HK639	negative
Streptococcus phage YMC-2011	positive
Vibrio phage pYD38-B	negative
Colwellia phage 9A	negative
Enterococcus phage phiEf11	positive
Cyanophage PSS2	negative
Escherichia virus EPS7	negative
Burkholderia virus phi6442	negative
Lactobacillus phage Lc-Nu	positive
Lactococcus phage 936 sensu lato	positive
Gordonia phage GTE2	positive
Mycobacterium phage Faith1	myco
Clostridium phage phiCD38-2	positive
Roseobacter phage RDJL Phi 1	negative
Synechococcus phage S-CBS3	negative
Synechococcus phage S-CBS2	negative
Shigella virus Shfl1	negative
Propionibacterium phage PAD20	positive
Propionibacterium phage PAS50	positive
Streptococcus phage M102	positive
Mycobacterium phage Angel	myco
Streptococcus phage PH10	positive
Streptococcus phage 5093	positive
Xanthomonas phage phiL7	negative
Lactococcus phage P087	positive
Enterococcus phage EFAP-1	positive
Escherichia virus SSL2009a	negative
Mycobacterium phage Phlyer	myco
Lactobacillus phage Lv-1	positive
Bacillus phage TP21-L	positive
Staphylococcus phage Ipla88	positive
Pseudomonas phage MP29	negative
Staphylococcus phage Ipla35	positive
Pseudomonas phage MP38	negative
Stenotrophomonas phage S1	negative
Lactococcus phage bIL67	positive
Pseudomonas phage PAJU2	negative
Stx2-converting phage 1717	negative
Clostridium phage phiCP39-O	positive
Listeria phage P40	positive
Mycobacterium phage Ramsey	myco
Mycobacterium phage Pacc40	myco
Mycobacterium phage Konstantine	myco
Mycobacterium phage Fruitloop	myco
Mycobacterium phage Troll4	myco
Mycobacterium phage Gumball	myco
Mycobacterium phage Brujita	myco
Mycobacterium phage Solon	myco
Bacteroides phage B40-8	negative
Bacillus virus IEBH	positive
Lactobacillus phage Lrm1	positive
Rhizobium phage 16-3	negative
Mycobacterium phage Porky	myco
Mycobacterium phage Phaedrus	myco
Mycobacterium phage Kostya	myco
Mycobacterium phage Boomer	myco
Mycobacterium phage Predator	myco
Mycobacterium phage Nigel	myco
Mycobacterium phage Pukovnik	myco
Mycobacterium phage Lockley	myco
Mycobacterium phage KBG	myco
Mycobacterium phage Jasper	myco
Mycobacterium phage DD5	myco
Streptococcus phage PH15	positive
Staphylococcus phage phiMR25	positive
Lactococcus phage 1706	positive
Salmonella phage Vi II-E1	negative
Azospirillum phage Cd	negative
Streptococcus phage 858	positive
Staphylococcus phage phiMR11	positive
Pseudomonas phage YuA	negative
Mycobacterium phage Giles	myco
Pseudomonas phage MP22	negative
Mycobacterium phage Bethlehem	myco
Mycobacterium phage U2	myco
Listeria phage A006	positive
Listeria phage P35	positive
Listeria phage B054	positive
Listeria phage B025	positive
Listeria phage A500	positive
Mycobacterium phage Tweety	myco
Streptococcus phage P9	positive
Corynebacterium phage P1201	positive
Thermus phage P7426	negative
Thermus phage P2345	negative
Corynebacterium phage BFK20	positive
Staphylococcus phage tp310-2	positive
Microbacterium phage Min1	positive
Lactobacillus phage LL-H	positive
Escherichia virus TLS	negative
Xanthomonas phage Xop411	negative
Propionibacterium phage PA6	positive
Staphylococcus phage 80alpha	positive
Enterobacteria phage cdtI	negative
Burkholderia phage BcepGomr	negative
Salmonella phage SETP3	negative
Streptococcus phage phi3396	positive
Staphylococcus phage phiETA3	positive
Staphylococcus phage phiETA2	positive
Streptococcus phage SMP	positive
Staphylococcus phage PH15	positive
Staphylococcus phage CNPH82	positive
Pseudomonas phage DMS3	negative
Archaeal BJ1 virus	archaea
Staphylococcus phage Pvl108	positive
Staphylococcus phage phiNM3	positive
Staphylococcus phage phiNM	positive
Mycobacterium phage Wildcat	myco
Mycobacterium phage Qyrzula	myco
Mycobacterium phage Pipefish	myco
Mycobacterium phage PMC	myco
Mycobacterium phage PLot	myco
Mycobacterium phage PBI1	myco
Mycobacterium phage Orion	myco
Mycobacterium phage Llij	myco
Mycobacterium phage Halo	myco
Mycobacterium phage Cooper	myco
Mycobacterium phage Che12	myco
Mycobacterium phage 244	myco
Streptomyces phage mu1/6	positive
Pseudomonas phage M6	negative
Pseudomonas phage 73	negative
Pseudomonas phage F10	negative
Bacillus phage Fah	positive
Bacillus virus Wbeta	positive
Xanthomonas phage OP1	negative
Escherichia virus Rtp	negative
Burkholderia phage Bcep176	negative
Phage phiJL001	negative
Bacillus phage Gamma	positive
Escherichia phage Jk06	negative
Staphylococcus phage 55	positive
Staphylococcus phage ROSA	positive
Staphylococcus phage EW	positive
Staphylococcus phage 37	positive
Staphylococcus phage 3A	positive
Staphylococcus phage 42E	positive
Staphylococcus phage 2638A	positive
Staphylococcus phage 187	positive
Streptococcus phage 2972	positive
Lactococcus phage BK5-T	positive
Yersinia phage PY54	negative
Enterobacteria phage ES18	negative
Listonella phage phiHSIC	negative
Salmonella phage SS3e	negative
Lactobacillus phage phijl1	positive
Escherichia virus T5	negative
Streptococcus phage DT1	positive
Streptomyces phage phiC31	positive
Lactobacillus phage A2	positive
Streptococcus phage MM1	positive
Escherichia virus HK97	negative
Listeria phage A118	positive
Lactobacillus phage phiadh	positive
Bacillus phage SPP1	positive
Flavobacterium phage 11b	negative
Bacillus phage BCJA1c	positive
Pseudomonas phage B3	negative
Pseudomonas phage D3	negative
Klebsiella phage phiKO2	negative
Streptomyces phage VWB	positive
Mycobacterium phage L5	myco
Burkholderia virus phi1026b	negative
Lactococcus phage bIL286	positive
Mycobacterium phage Che8	myco
Staphylococcus phage PVL	positive
Actinoplanes phage phiAsp2	positive
Lactococcus phage phiLC3	positive
Staphylococcus phage 77	positive
Lactobacillus prophage Lj965	positive
Lactobacillus prophage Lj928	positive
Mycobacterium phage Che9d	myco
Lactococcus phage bIL309	positive
Pseudomonas phage D3112	negative
Lactococcus phage ul36	positive
Burkholderia virus phiE125	negative
Lactobacillus phage phig1e	positive
Burkholderia phage BcepNazgul	negative
Mycobacterium phage Rosebush	myco
Streptococcus phage SM1	positive
Xanthomonas phage Xp10	negative
Methanothermobacter phage psiM100	archaea
Enterobacteria phage BP-4795	negative
Lactococcus phage P335 sensu lato	positive
Streptomyces phage phiBT1	positive
Mycobacterium phage Bxz2	myco
Mycobacterium phage Barnyard	myco
Mycobacterium phage Omega	myco
Mycobacterium phage Corndog	myco
Mycobacterium phage Che9c	myco
Mycobacterium phage Cjw1	myco
Staphylococcus phage 13	positive
Staphylococcus phage Phi12	positive
Staphylococcus phage 11	positive
Streptococcus phage O1205	positive
Lactococcus phage r1t	positive
Bacillus phage phi105	positive
Escherichia virus Lambda	negative
Mycobacterium phage D29	myco
Clostridium phage phi3626	positive
Methanobacterium phage psiM2	archaea
Mycobacterium phage TM4	myco
Temperate phage phiNIH1.1	positive
Listeria phage 2389	positive
Staphylococcus phage phiETA	positive
Lactococcus phage bIL311	positive
Staphylococcus phage Slt	positive
Staphylococcus prophage phiPV83	positive
Streptococcus phage Sfi21	positive
Lactococcus phage Tuc2009	positive
Lactococcus phage TP901-1	positive
Lactococcus phage bIL312	positive
Lactococcus phage bIL310	positive
Lactococcus phage bIL285	positive
Mycobacterium phage Bxb1	myco
Escherichia virus N15	negative
Streptococcus phage Sfi11	positive
Streptococcus phage 7201	positive
Escherichia virus HK022	negative
Streptococcus phage Sfi19	positive
Bacillus virus SPbeta	positive
Lactococcus phage c2	positive
Pseudoalteromonas phage H105/1	negative
Streptococcus phage Dp-1	positive
Enterococcus phage EFRM31	positive
Salmonella virus SPC35	negative
Lactococcus phage 949	positive
Clostridium phage phiCD6356	positive
Brochothrix phage BL3	positive
Brochothrix phage NF5	positive
Tsukamurella phage TPA2	positive
Mycobacterium phage Wee	myco
Mycobacterium phage bron	myco
Staphylococcus phage Sap26	positive
Mycobacterium phage CrimD	myco
Mycobacterium phage Angelica	myco
Clostridium phage phiCTP1	positive
Streptomyces phage phiSASD1	positive
Cellulophaga phage phiST	negative
Synechococcus phage S-CBS4	negative
Synechococcus phage S-SKS1	negative
Rhodovulum phage RS1	negative
Rhodobacter phage RC1	negative
Paenibacillus phage PG1	positive
Vibrio phage pYD21-A	negative
Mycobacterium phage Ardmore	myco
Clavibacter phage CMP1	positive
Mycobacterium phage Peaches	myco
Enterococcus phage phiFL2A	positive
Enterococcus phage phiFL4A	positive
Streptococcus phage Abc2	positive
Enterococcus phage phiFL1A	positive
Enterococcus phage phiFL3A	positive
Sodalis phage SO1	negative
Streptococcus phage Alq132	positive
Vibrio phage SIO-2	negative
Staphylococcus phage P954	positive
Burkholderia phage KS9	negative
