Salmonella phage GG32	negative
Campylobacter phage PC14	negative
Synechococcus phage S-WAM1	negative
Synechococcus phage S-WAM2	negative
Escherichia phage MX01	negative
Escherichia phage WG01	negative
Salmonella phage BPS15Q2	negative
Bacillus virus Bp8pC	positive
Arthrobacter phage BarretLemon	positive
Acinetobacter phage vB_AbaM_phiAbaA1	negative
Bacillus phage SP-15	positive
Cyanophage S-RIM50	negative
Cyanophage S-RIM32	negative
Bacillus phage Deep Blue	positive
Salmonella phage SJ46	negative
Aggregatibacter phage S1249	negative
Staphylococcus phage Stau2	positive
Bacillus phage SPG24	positive
Bacillus phage Shbh1	positive
Bacillus phage Eldridge	positive
Ralstonia phage RSP15	negative
Pseudomonas phage K5	negative
Pseudomonas phage phi3	negative
Pseudomonas phage vB_PsyM_KIL1	negative
Shigella phage SHSML-52-1	negative
Enterobacter phage Arya	negative
Salmonella phage vB_SalM_PM10	negative
Mycobacterium phage Tonenili	myco
Shigella phage SHBML-50-1	negative
Shigella phage SHFML-26	negative
Shigella phage SHSML-45	negative
Salmonella phage vB_SnwM_CGG4-1	negative
Pseudomonas phage phiMK	negative
Bacillus phage SalinJah	positive
Escherichia phage UFV-AREG1	negative
Bacillus phage Belinda	positive
Klebsiella phage vB_KpnM_KpV477	negative
Morganella phage vB_MmoM_MP1	negative
Citrobacter phage vB_CfrM_CfP1	negative
Bacillus phage AR9	positive
Salmonella phage NR01	negative
Escherichia phage HY03	negative
Klebsiella phage PKO111	negative
Acinetobacter phage LZ35	negative
Bacillus phage DIGNKC	positive
Bacillus phage Nemo	positive
Bacillus phage Nigalana	positive
Bacillus phage NotTheCreek	positive
Bacillus phage Phrodo	positive
Bacillus phage SageFayge	positive
Bacillus phage Zuko	positive
Escherichia phage vB_EcoM_Alf5	negative
Bacillus phage Kida	positive
Bacillus phage DirtyBetty	positive
Erwinia phage vB_EamM_Asesino	negative
Erwinia phage vB_EamM_ChrisDB	negative
Erwinia phage vB_EamM_EarlPhillipIV	negative
Erwinia phage vB_EamM_Huxley	negative
Erwinia phage vB_EamM_Kwan	negative
Erwinia phage vB_EamM_Phobos	negative
Escherichia phage vB_EcoM-UFV13	negative
Shigella phage SHFML-11	negative
Pseudomonas phage PaoP5	negative
Escherichia phage APCEc01	negative
Bacillus phage BM5	positive
Pseudoalteromonas phage H101	negative
Pseudomonas phage VCM	negative
Brevibacillus phage Jimmer1	positive
Staphylococcus phage 812	positive
Lactobacillus phage LfeInf	positive
Clostridium phage phiCDHM13	positive
Salmonella phage 19	negative
Salmonella phage 21	negative
Clostridium phage phiCD211	positive
Mycobacterium phage Breeniome	myco
Salmonella phage 38	negative
Lactobacillus phage phi jlb1	positive
Clostridium phage phiCD505	positive
Clostridium phage phiMMP03	positive
Clostridium phage phiCD481-1	positive
Clostridium phage phiCD506	positive
Clostridium phage phiMMP01	positive
Enterobacteria phage vB_EcoM_VR5	negative
Escherichia phage vB_EcoM_VR20	negative
Escherichia phage vB_EcoM_VR25	negative
Escherichia phage vB_EcoM_VR26	negative
Mannheimia phage vB_MhM_587AP1	negative
Mannheimia phage vB_MhM_3927AP2	negative
Mycobacterium phage Alice	myco
Acinetobacter phage phiAC-1	negative
Bacillus phage JL	positive
Bacillus phage Shanette	positive
Brevibacillus phage Abouo	positive
Cronobacter phage S13	negative
Escherichia phage JH2	negative
Microcystis phage MaMV-DC	negative
Escherichia phage HY02	negative
Pectobacterium bacteriophage PM2	negative
Yersinia phage vB_YenM_TG1	negative
Enterococcus phage EFDG1	positive
Bacillus phage TsarBomba	positive
Brevibacillus phage Osiris	positive
Bacillus phage AvesoBmore	positive
Mycobacterium phage HyRo	myco
Pseudomonas phage K8	negative
Enterobacteria phage WPhi	negative
Stenotrophomonas phage IME13	negative
Clostridium phage phiCDHM11	positive
Clostridium phage phiCDHM19	positive
Prochlorococcus phage P-TIM68	negative
Staphylococcus phage phiIPLA-RODI	positive
Staphylococcus phage phiIPLA-C1C	positive
Ralstonia phage RSL2	negative
Vibrio phage ValKK3	negative
Pseudomonas phage DL68	negative
Citrobacter phage IME-CF2	negative
Ralstonia phage RSF1	negative
Escherichia phage SUSP1	negative
Escherichia phage SUSP2	negative
Escherichia phage slur02	negative
Escherichia phage slur07	negative
Acinetobacter phage vB_AbaM_IME200	negative
Escherichia virus 186	negative
Pseudomonas phage PhiPA3	negative
Acinetobacter phage YMC11/12/R2315	negative
Escherichia phage vB_EcoM_AYO145A	negative
Proteus phage vB_PmiM_Pm5461	negative
Enterococcus phage EFLK1	positive
Sinorhizobium phage phiN3	negative
Salmonella phage SEN1	negative
Salmonella phage SEN4	negative
Escherichia phage pro147	negative
Escherichia phage pro483	negative
Enterobacteria phage QL01	negative
Bacillus phage Eyuki	positive
Pseudomonas phage vB_Pae_PS44	negative
Pseudomonas phage vB_PaeM_PS24	negative
Pseudomonas phage DL60	negative
Cyanophage P-TIM40	negative
Klebsiella phage vB_KpnM_KB57	negative
Salmonella phage SEN5	negative
Klebsiella phage JD18	negative
Cronobacter phage PBES 02	negative
Edwardsiella phage PEi20	negative
Sinorhizobium phage phiM9	negative
Pseudomonas phage C11	negative
Escherichia phage slur08	negative
Escherichia phage slur16	negative
Campylobacter virus CP220	negative
Staphylococcus phage SA1	positive
Campylobacter virus CPt10	negative
Vibrio phage VP585	negative
Lactobacillus phage LBR48	positive
Enterobacteria phage SfMu	negative
Salmonella phage SPN3US	negative
Bacillus phage BCP8-2	positive
Enterobacteriaphage UAB_Phi87	negative
Enterobacteria phage SfI	negative
Escherichia phage HY01	negative
Bacillus phage JBP901	positive
Citrobacter phage Moon	negative
Escherichia phage vB_EcoM-VpaE1	negative
Acinetobacter phage YMC13/03/R2096	negative
Salmonella phage STML-198	negative
Escherichia phage EC6	negative
Escherichia phage PBECO 4	negative
Yersinia phage PST	negative
Klebsiella phage K64-1	negative
Vibrio phage PV94	negative
Enterococcus phage ECP3	positive
Salmonella phage SSE121	negative
Salmonella phage HB-2014	negative
Erwinia phage phiEa2809	negative
Rhizobium phage RHE	negative
Sinorhizobium phage phiM19	negative
Synechococcus phage ACG-2014i	negative
Synechococcus phage ACG-2014b	negative
Flavobacterium phage FCL-2	negative
Salmonella phage Det7	negative
Citrobacter phage Miller	negative
Synechococcus phage ACG-2014f	negative
Synechococcus phage ACG-2014g	negative
Synechococcus phage ACG-2014j	negative
Synechococcus phage ACG-2014d	negative
Synechococcus phage ACG-2014e	negative
Arthrobacter phage vB_ArtM-ArV1	positive
Edwardsiella phage GF-2	negative
Pseudomonas phage vB_PaeM_PAO1_Ab03	negative
Pseudomonas phage vB_PaeM_C1-14_Ab28	negative
Salmonella phage STP4-a	negative
Pseudomonas phage vB_PaeM_PAO1_Ab27	negative
Dickeya phage RC-2014	negative
Lactobacillus phage phiAQ113	positive
Enterobacteria phage P88	negative
Escherichia phage Av-05	negative
Shigella phage pSs-1	negative
Escherichia phage ECML-117	negative
Escherichia phage ECML-4	negative
Listeria phage WIL-1	positive
Shigella phage Shf125875	negative
Staphylococcus phage Team1	positive
Caulobacter phage Cr30	negative
Bacillus phage CP-51	positive
Staphylococcus phage MCE-2014	positive
Escherichia phage ECML-134	negative
unclassified Myoviridae	unknown
Acinetobacter phage vB_AbaM_Acibel004	negative
Aeromonas phage pAh6-C	negative
Rhizobium phage vB_RleM_P10VF	negative
Escherichia phage vB_EcoM-ep3	negative
Escherichia phage 121Q	negative
Rhizobium phage vB_RleM_PPF1	negative
Staphylococcus phage P108	positive
T4virus	negative
Ralstonia phage RSY1	negative
Escherichia phage vB_EcoM_PhAPEC2	negative
Acinetobacter phage YMC-13-01-C62	negative
Bacillus phage Bobb	positive
Listeria phage LMTA-148	positive
Bacillus phage Riley	positive
Listeria phage LP-083-2	positive
Listeria phage LP-048	positive
Cronobacter phage CR8	negative
Vibrio phage X29	negative
Listeria phage LMSP-25	positive
Listeria phage List-36	positive
Bacillus phage Evoli	positive
Bacillus phage Megatron	positive
Bacillus phage CAM003	positive
Bacillus phage Hoody T	positive
Bacillus phage Hakuna	positive
Bacillus phage Bcp1	positive
Clostridium phage CDMH1	positive
Escherichia phage FFH2	negative
Escherichia phage vB_EcoM_112	negative
Serratia phage PS2	negative
Salmonella phage vB_SalM_SJ3	negative
Escherichia phage vB_EcoM_JS09	negative
Brevibacillus phage Davies	positive
Salmonella phage Maynard	negative
Pectobacterium phage PM1	negative
Salmonella phage vB_SalM_SJ2	negative
Mycobacterium phage Nappy	myco
Mycobacterium phage MoMoMixon	myco
Cronobacter phage CR9	negative
Aeromonas phage PX29	negative
Mycobacterium phage Dandelion	myco
Mycobacterium phage LinStu	myco
Mycobacterium phage Pleione	myco
Bacillus virus G	positive
Enterobacter phage PG7	negative
Stenotrophomonas phage Smp131	negative
Synechococcus phage ACG-2014h	negative
Synechococcus phage S-MbCM100	negative
Shewanella phage Spp001	negative
Erwinia phage Ea35-70	negative
Pseudomonas phage phiPsa374	negative
Vibrio phage VH7D	negative
Staphylococcus phage phiSA12	positive
Bacillus phage BPS10C	positive
Staphylococcus phage Sb-1	positive
Pseudomonas phage PPpW-3	negative
Pseudomonas phage PAK_P5	negative
Pseudomonas phage PAK_P3	negative
Pseudomonas phage CHA_P1	negative
Pseudomonas phage PAK_P4	negative
Pseudomonas phage PAK_P2	negative
Escherichia phage 4MG	negative
Staphylococcus phage S25-3	positive
Staphylococcus phage S25-4	positive
Bacillus phage Grass	positive
Bacillus phage Spock	positive
Bacillus phage BigBertha	positive
Bacillus phage CampHawk	positive
Salmonella phage Marshall	negative
Shigella phage SfIV	negative
Enterobacteria phage fiAA91-ss	negative
Enterobacteria phage GEC-3S	negative
Escherichia phage JES2013	negative
Klebsiella phage 0507-KN2-1	negative
Edwardsiella phage eiAU	negative
Staphylococcus phage vB_SauM_Remus	positive
Pseudomonas phage PaBG	negative
Bacillus phage Troll	positive
Shigella phage SfII	negative
Bacillus phage phiNIT1	positive
Listeria phage LP-125	positive
Salmonella phage FSL SP-004	negative
Cronobacter phage CR5	negative
Vibrio phage nt-1	negative
Vibrio phage KVP40	negative
Vibrio phage VPUSM 8	negative
Burkholderia phage ST79	negative
Escherichia phage Lw1	negative
Mycobacterium phage Astraea	myco
Mycobacterium phage Gizmo	myco
Mycobacterium phage ArcherS7	myco
Rhodococcus phage E3	positive
Edwardsiella phage PEi2	negative
Bacillus phage vB_BceM-Bc431v3	positive
Aeromonas phage Aes012	negative
Staphylococcus phage vB_SauM_Romulus	positive
Listeria phage vB_LmoM_AG20	positive
Pelagibacter phage HTVC008M	negative
Salmonella phage vB_SenMS16	negative
Klebsiella phage JD001	negative
Pectobacterium phage phiTE	negative
Serratia phage phiMAM1	negative
Edwardsiella phage MSW-3	negative
Bacillus phage phiAGATE	positive
Dickeya virus Limestone	negative
Escherichia phage phAPEC8	negative
Klebsiella phage KP27	negative
Cronobacter phage ENT47670	negative
Erwinia phage ENT90	negative
Pseudomonas phage KPP12	negative
Salmonella phage SKML-39	negative
Pseudomonas phage PaP1	negative
Staphylococcus phage JD007	positive
Vibrio phage vB_VpaM_MAR	negative
Aeromonas phage CC2	negative
Aeromonas phage Aes508	negative
Staphylococcus virus SA11	positive
Campylobacter virus CP21	negative
Cyanophage S-TIM5	negative
Salmonella phage PhiSH19	negative
Escherichia phage ime09	negative
Escherichia phage wV7	negative
Erwinia phage vB_EamM-Y2	negative
Agrobacterium phage 7-7-1	negative
Sphingomonas phage PAU	negative
Enterobacteria phage vB_KleM-RaK2	negative
Bacillus phage BCD7	positive
Escherichia phage FV3	negative
Vibrio phage vB_VchM-138	negative
Pectobacterium phage ZF40	negative
Bdellovibrio phage phi1422	negative
Aeromonas phage vB_AsaM-56	negative
Enterobacteria phage Bp7	negative
Bacillus phage SP-10	positive
Escherichia phage PhaxI	negative
Synechococcus phage metaG-MbCM1	negative
Synechococcus phage ACG-2014c	negative
Salmonella phage RE-2010	negative
Staphylococcus phage GH15	positive
Pseudomonas phage JG004	negative
Pseudomonas phage JG024	negative
Haemophilus phage SuMu	negative
Pseudomonas phage NH-4	negative
Vibrio phage CP-T1	negative
Pseudomonas phage vB_PaeM_C2-10_Ab1	negative
Yersinia phage phiD1	negative
Yersinia phage phiR1-RT	negative
Clostridium phage phiMMP04	positive
Clostridium phage phiMMP02	positive
Escherichia phage vB_EcoM_ACG-C40	negative
Cronobacter phage vB_CsaM_GAP161	negative
Cronobacter phage vB_CsaM_GAP32	negative
Cronobacter phage vB_CsaM_GAP31	negative
Bacillus phage Bastille	positive
Campylobacter phage CP30A	negative
Escherichia phage HX01	negative
Bacillus phage B4	positive
Bacillus phage BPS13	positive
Bacillus phage BCP78	positive
Enterobacteria phage phi92	negative
Acinetobacter phage ZZ1	negative
Pseudomonas phage Lu11	negative
Acinetobacter bacteriophage AP22	negative
Halocynthia phage JM-2012	unknown
Xanthomonas phage vB_XveM_DIBBI	negative
Cronobacter phage CR3	negative
Pseudomonas phage OBP	negative
Escherichia phage Cba120	negative
Bacillus phage W.Ph.	positive
Campylobacter virus CPX	negative
Yersinia phage phiR1-37	negative
Salmonella phage PVP-SE1	negative
Salmonella phage SFP10	negative
Rhizobium phage RR1-B	negative
Escherichia phage vB_EcoM_ECO1230-10	negative
Escherichia phage AR1	negative
Thermus phage TMA	negative
Thermus phage phiYS40	negative
Synechococcus phage S-RIM2	negative
Synechococcus phage S-RIM8	negative
Synechococcus phage S-CAM8	negative
Synechococcus phage S-RSM4	negative
Iodobacteriophage phiPLPE	negative
Synechococcus phage S-SM1	negative
Synechococcus phage Syn19	negative
Prochlorococcus phage P-SSM7	negative
Prochlorococcus phage P-HM2	negative
Prochlorococcus phage P-HM1	negative
Prochlorococcus phage P-RSM4	negative
Synechococcus phage S-SSM7	negative
Synechococcus phage S-ShM2	negative
Synechococcus phage S-SSM5	negative
Synechococcus phage S-SM2	negative
Enterococcus phage phiEF24C	positive
Enterobacteria phage Phi1	negative
Burkholderia virus phiE255	negative
Burkholderia virus phiE202	negative
Burkholderia virus phiE122	negative
Prochlorococcus phage P-SSM2	negative
Bdellovibrio phage phi1402	negative
Synechococcus phage S-CRM01	negative
Campylobacter virus NCTC12673	negative
Shigella phage Shfl2	negative
Escherichia phage wV8	negative
Enterobacteria phage JS10	negative
Enterobacteria phage JSE	negative
Enterobacteria phage RB14	negative
Enterobacteria phage RB51	negative
Lactobacillus phage Lb338-1	positive
Erwinia phage phiEa21-4	negative
Pseudomonas phage PB1	negative
Pseudomonas phage SN	negative
Pseudomonas phage 14-1	negative
Bacillus virus SPO1	positive
Clostridium virus phiCD27	positive
Mycobacterium phage Cali	myco
Mycobacterium phage Spud	myco
Mycobacterium phage ScottMcG	myco
Mycobacterium phage Rizal	myco
Mycobacterium phage Myrna	myco
Burkholderia phage KS10	negative
Pseudomonas phage LMA2	negative
Pseudomonas phage LBL3	negative
Escherichia phage V5	negative
Pseudomonas phage 201phi2-1	negative
Ralstonia phage RSL1	negative
Halomonas phage phiHAP-1	negative
Enterobacteria phage JS98	negative
Enterobacteria phage phiEcoM-GJ1	negative
Listeria virus A511	positive
Bacillus phage 0305phi8-36	positive
Burkholderia virus BcepNY3	negative
Aeromonas virus phiO18P	negative
Ralstonia phage RSA1	negative
Clostridium virus phiC2	positive
Burkholderia virus BcepF1	negative
Vibrio phage VP882	negative
Microcystis aeruginosa phage Ma-LMM01	negative
Enterobacteria phage RB32	negative
Synechococcus phage syn9	negative
Mycobacterium phage Catera	myco
Pasteurella phage F108	negative
Aeromonas virus 25	negative
Mannheimia phage phiMHaA1	negative
Lactobacillus phage KC5a	positive
Clostridium virus phiCD119	positive
Pseudomonas phage F8	negative
Xanthomonas phage OP2	negative
Pseudomonas phage EL	negative
Clostridium phage c-st	positive
Burkholderia virus phi52237	negative
Enterobacteria phage RB43	negative
Aeromonas virus 31	negative
Staphylococcus virus G1	positive
Staphylococcus phage Twort	positive
Haemophilus phage Aaphi23	negative
Synechococcus phage S-PM2	negative
Enterobacteria phage RB69	negative
Prochlorococcus phage P-SSM4	negative
Streptococcus phage EJ-1	positive
Enterobacteria phage phiP27	negative
Lactobacillus phage LP65	positive
Escherichia virus P1	negative
Staphylococcus virus K	positive
Burkholderia phage BcepB1A	negative
Rhodothermus phage RM378	negative
Pseudomonas phage phiCTX	negative
Enterobacteria phage P4	negative
Burkholderia virus Bcep43	negative
Burkholderia virus Bcep1	negative
Burkholderia virus Bcep781	negative
Burkholderia virus BcepMu	negative
Salmonella virus PsP3	negative
Salmonella phage FelixO1	negative
Aeromonas virus 44RR2	negative
Aeromonas virus Aeh1	negative
Mycobacterium phage Bxz1	myco
Enterobacteria phage RB49	negative
Yersinia phage L-413C	negative
Pseudomonas phage phiKZ	negative
Vibrio phage VHML	negative
Haemophilus phage HP2	negative
Natrialba phage PhiCh1	archaea
Enterobacteria phage SfV	negative
Vibrio phage K139	negative
Escherichia virus Mu	negative
Haemophilus phage HP1	negative
Enterobacteria phage T4	negative
Escherichia virus P2	negative
Salmonella phage ViI	negative
Erwinia phage phiEt88	negative
Pseudomonas phage PAK_P1	negative
Erwinia phage phiEa104	negative
Burkholderia phage KS14	negative
Pseudomonas phage KPP10	negative
Burkholderia phage KL3	negative
Burkholderia phage KS5	negative
Brochothrix phage A9	positive
Aeromonas virus 65	negative
Acinetobacter virus 133	negative
Vibrio phage ICP1	negative
Escherichia phage vB_EcoM_VR7	negative
Acinetobacter phage Acj9	negative
Enterobacter phage CC31	negative
Acinetobacter phage Acj61	negative
Acinetobacter phage Ac42	negative
Aeromonas phage phiAS5	negative
Aeromonas phage phiAS4	negative
Shigella phage SP18	negative
Cyanophage P-RSM6	negative
Cyanophage P-RSM1	negative
Prochlorococcus phage MED4-213	negative
Prochlorococcus phage MED4-184	negative
Enterobacteria phage RB16	negative
Enterobacteria phage IME08	negative
Cellulophaga phage phiSM	negative
Vibrio phage 11895-B1	negative
Prochlorococcus phage P-SSM3	negative
Synechococcus phage S-IOM18	negative
Synechococcus phage S-CAM1	negative
Rhizobium phage RR1-A	negative
Psychrobacter phage pOW20-A	negative
Klebsiella phage KP15	negative
Delftia phage phiW-14	negative
Shigella phage Ag3	negative
Mycobacterium phage ET08	myco
Escherichia phage D108	negative
Synechococcus phage S-SSM4	negative
Vibrio phage martha 12B12	negative
