Escherichia phage LM33_P1	negative
Escherichia phage vB_EcoP_GA2A	negative
Salmonella phage 103203_sal5	negative
Klebsiella phage vB_KpnP_KpV71	negative
Salmonella phage BP12B	negative
Salmonella phage BP12A	negative
Pseudomonas phage YMC11/06/C171_PPU_BP	negative
Salmonella phage 118970_sal4	negative
Enterobacter phage Tyrion	negative
Enterobacteria phage UAB_Phi20	negative
Staphylococcus phage SLPW	positive
Escherichia phage 64795_ec1	negative
Pseudomonas phage PEV2	negative
Pseudomonas phage Andromeda	negative
Pectobacterium phage PP16	negative
Pectobacterium phage PP90	negative
Morganella phage vB_MmoP_MP2	negative
Erwinia phage vB_EamP_Frozen	negative
Klebsiella phage vB_KpnP_KpV475	negative
Acinetobacter phage phiAB6	negative
Citrobacter phage SH1	negative
Citrobacter phage SH2	negative
Citrobacter phage SH3	negative
Citrobacter phage SH4	negative
Staphylococcus phage BP39	positive
Pseudomonas phage vB_PaeP_MAG4	negative
Bacillus phage Aurora	positive
Bacillus phage Claudi	positive
Bacillus phage Stitch	positive
Rhodoferax phage P26218	negative
Shigella phage 75/02 Stx	negative
Pseudomonas phage YH30	negative
Pectobacterium phage Peat1	negative
Enterobacter phage E-2	negative
Cronobacter phage Dev-CD-23823	negative
Podovirus Lau218	negative
Achromobacter phage phiAxp-3	negative
Citrobacter phage phiCFP-1	negative
Enterobacter phage phiEap-1	negative
Escherichia phage P483	negative
Escherichia phage P694	negative
Pseudomonas phage PhiCHU	negative
Vibrio phage phi 1	negative
Bacillus phage Palmer	positive
Escherichia phage 172-1	negative
Bacillus phage VMY22	positive
Ralstonia phage RSJ2	negative
Ralstonia phage RSJ5	negative
Enterobacter phage E-3	negative
Pseudomonas phage DL54	negative
Pseudomonas phage DL62	negative
Pseudomonas phage DL64	negative
Klebsiella phage K5	negative
Klebsiella phage vB_KpnP_KpV289	negative
Yersinia phage vB_YenP_ISAO8	negative
Pseudomonas phage KPP21	negative
Klebsiella phage vB_KpnP_SU503	negative
Klebsiella phage vB_KpnP_SU552A	negative
Proteus phage vB_PmiP_Pm5460	negative
Acinetobacter phage Fri1	negative
Bacillus phage Pavlov	positive
Delftia phage IME-DE1	negative
Klebsiella phage vB_Kp1	negative
Salmonella phage SEN22	negative
Gordonia phage GTE8	positive
Enterococcus phage vB_EfaP_IME195	positive
Pseudomonas phage PPPL-1	negative
Streptococcus phage Str-PAP-1	positive
Yersinia phage vB_YenP_AP10	negative
Gordonia phage GMA3	positive
Acinetobacter phage vB_AbaP_PD-AB9	negative
Enterobacteria phage VT2phi_272	negative
Escherichia phage phi191	negative
Klebsiella phage vB_KpnP_KpV41	negative
Streptococcus phage T12	positive
Mycobacterium phage Phlei	myco
Gordonia phage GMA7	positive
Gordonia phage GTE6	positive
Streptococcus phage A25	positive
Acinetobacter phage phiAB1	negative
Shigella phage Ss-VASD	negative
Klebsiella phage vB_Kp2	negative
Salmonella phage SEN34	negative
Acinetobacter phage vB_AbaP_PD-6A3	negative
Escherichia phage PA2	negative
Citrobacter phage CVT22	negative
Stx2 converting phage vB_EcoP_24B	negative
Proteus phage PM16	negative
Phage vB_EcoP_SU10	negative
Enterobacteria phage Sf101	negative
Pseudomonas phage vB_PaeP_PPA-ABTNL	negative
Escherichia phage Pollock	negative
Vibrio phage J2	negative
Vibrio phage QH	negative
Proteus phage PM 75	negative
Proteus phage PM 85	negative
Proteus phage PM 93	negative
Pseudomonas phage YH6	negative
Escherichia phage CICC 80001	negative
Pseudomonas phage Pa2	negative
Delftia phage RG-2014	negative
Escherichia phage ECBP5	negative
Pseudomonas phage Pf-10	negative
Vibrio phage phiVC8	negative
Pseudomonas phage vB_PaeP_PAO1_Ab05	negative
Pseudomonas phage vB_PaeP_C2-10_Ab22	negative
Cronobacter phage Dev2	negative
Escherichia phage ECBP1	negative
Escherichia phage ECBP2	negative
Vibrio phage phi-A318	negative
Shigella phage POCJ13	negative
Enterobacteria phage J8-65	negative
Klebsiella phage NTUH-K2044-K1-1	negative
Salmonella phage 9NA	negative
Enterococcus phage vB_Efae230P-4	positive
Synechococcus phage S-CBP1	negative
Acinetobacter phage vB_AbaP_Acibel007	negative
Mesorhizobium phage vB_MloP_Lo5R7ANS	negative
Yersinia phage vB_YenP_AP5	negative
Lelliottia phage phD2B	negative
Vibrio phage ICP2_2013_A_Haiti	negative
Escherichia phage vB_EcoP_PhAPEC7	negative
Escherichia phage vB_EcoP_PhAPEC5	negative
Escherichia phage PE3-1	negative
Dinoroseobacter phage DFL12phi1	negative
Pseudomonas phage phiPSA2	negative
Anabaena phage A-4L	negative
Escherichia phage Bp4	negative
Lactoccocus phage WP-2	positive
Pseudomonas phage vB_PaeP_C2-10_Ab09	negative
Pseudomonas phage KPP25	negative
Vibrio phage CHOED	negative
Escherichia phage KBNP1711	negative
Yersinia phage Yep-phi	negative
Ralstonia phage RSB2	negative
Klebsiella phage F19	negative
Vibrio phage PVA1	negative
Acinetobacter phage Petty	negative
Acinetobacter phage Presley	negative
Achromobacter phage JWAlpha	negative
Erwinia phage Ea9-2	negative
Shigella phage pSb-1	negative
Staphylococcus phage GRCS	positive
Citrobacter phage CR44b	negative
Citrobacter phage CR8	negative
Pseudomonas phage TL	negative
Pseudomonas phage PPpW-4	negative
Xylella phage Paz	negative
Xylella phage Prado	negative
Pseudomonas phage phiIBB-PAA2	negative
Burkholderia phage JG068	negative
Ralstonia phage RSB3	negative
Ralstonia phage RSK1	negative
Bacillus phage Page	positive
Bacillus phage Pony	positive
Cyanophage PP	negative
Erwinia phage FE44	negative
Pseudomonas phage MPK6	negative
Pseudomonas phage MPK7	negative
Puniceispirillum phage HMO-2011	negative
Cellulophaga phage phi17:2	negative
Cellulophaga phage phi46:3	negative
Cellulophaga phage phi18:3	negative
Cellulophaga phage phi38:1	negative
Cellulophaga phage phi14:2	negative
Cellulophaga phage phi13:2	negative
Cellulophaga phage phi4:1	negative
Cellulophaga phage phi19:3	negative
Salmonella phage FSL SP-076	negative
Salmonella phage FSL SP-058	negative
Vibrio phage VPMS1	negative
Vibrio phage JA-1	negative
Acinetobacter phage AB3	negative
Bacillus phage MG-B1	positive
Acinetobacter phage Abp1	negative
Pseudoalteromonas phage RIO-1	negative
Pseudomonas phage Phi-S1	negative
Alteromonas phage vB_AmaP_AD45-P	negative
Vibrio phage VvAW1	negative
Pelagibacter phage HTVC019P	negative
Pelagibacter phage HTVC011P	negative
Pelagibacter phage HTVC010P	negative
Enterobacteria phage UAB_Phi78	negative
Xanthomonas citri phage CP2	negative
Cronobacter phage vB_CskP_GAP227	negative
Helicobacter phage KHP30	negative
Helicobacter phage KHP40	negative
Erwinia phage phiEa100	negative
Pseudomonas phage AF	negative
Burkholderia virus Bcepmigl	negative
Pseudomonas phage vB_PaeP_p2-10_Or1	negative
Salinivibrio phage CW02	negative
Liberibacter phage SC2	negative
Liberibacter phage SC1	negative
Acinetobacter phage Bphi-B1251	negative
Pectobacterium phage PP1	negative
Helicobacter phage 1961P	negative
Enterobacteria phage IME10	negative
Erwinia phage vB_EamP-S6	negative
Erwinia phage vB_EamP-L1	negative
Escherichia phage phiKT	negative
Aeromonas phage phiAS7	negative
Clostridium phage phi24R	positive
Pantoea phage LIMElight	negative
Escherichia phage TL-2011c	negative
Escherichia phage TL-2011b	negative
Enterobacter phage EcP1	negative
Brucella phage Pr	negative
Brucella phage Tb	negative
Yersinia phage phi80-18	negative
Edwardsiella phage KF-1	negative
Stenotrophomonas phage IME15	negative
Escherichia phage IME11	negative
Enterobacteria phage vB_EcoP_ACG-C91	negative
Cronobacter phage vB_CsaP_GAP52	negative
Pseudomonas phage UFV-P2	negative
Escherichia phage P13374	negative
Enterobacteria phage NJ01	negative
Burkholderia virus DC1	negative
Weissella phage phiYS61	positive
Salmonella phage vB_SemP_Emek	negative
Clostridium phage phiZP2	positive
Clostridium phage phiCPV4	positive
Pseudomonas phage tf	negative
Salmonella phage SPN9CC	negative
Clostridium phage phiCP7R	positive
Pseudomonas phage vB_Pae-TbilisiM32	negative
Erwinia phage PEp14	negative
Pseudomonas phage Bf7	negative
Salmonella phage SPN1S	negative
Staphylococcus phage S24-1	positive
Planktothrix phage PaV-LD	negative
Prochlorococcus phage P-SSP10	negative
Cyanophage NATL2A-133	negative
Cyanophage 9515-10a	negative
Cyanophage NATL1A-7	negative
Salmonella phage 7-11	negative
Escherichia phage vB_EcoP_G7C	negative
Enterobacteria phage 285P	negative
Yersinia phage Yepe2	negative
Klebsiella phage K11	negative
Enterobacteria phage EcoDS1	negative
Enterobacteria phage BA14	negative
Enterobacteria phage 13a	negative
Prochlorococcus phage P-SSP7	negative
Enterobacteria phage T7	negative
Enterobacteria phage 933W sensu lato	negative
Enterobacteria phage K30	negative
Pantoea phage LIMEzero	negative
Burkholderia virus Bcepil02	negative
Silicibacter phage DSS3phi2	negative
Sulfitobacter phage EE36phi1	negative
Vibrio phage VP93	negative
Pseudomonas phage phikF77	negative
Salmonella phage epsilon34	negative
Salmonella phage SE1	negative
Bacteriophage APSE-2	negative
Kluyvera phage Kvp1	negative
Ralstonia phage RSB1	negative
Pseudomonas phage PT2	negative
Morganella phage MmP1	negative
Bacillus virus phi29	positive
Salmonella phage phiSG-JL2	negative
Enterobacteria phage Min27	negative
Lactococcus phage asccphi28	positive
Pseudomonas phage LUZ19	negative
Pseudomonas phage LUZ24	negative
Escherichia virus phiEco32	negative
Thalassomonas phage BA3	negative
Pseudomonas phage LKA1	negative
Pseudomonas phage LKD16	negative
Staphylococcus phage SAP-2	positive
Lactococcus phage KSY1	positive
Actinomyces virus Av1	positive
Phormidium phage Pf-WMP3	negative
Synechococcus phage Syn5	negative
Erwinia amylovora phage Era103	negative
Escherichia phage N4	negative
Yersinia phage Berlin	negative
Stx2-converting phage 86	negative
Phormidium phage Pf-WMP4	negative
Escherichia virus K1-5	negative
Pseudomonas phage 119X	negative
Escherichia phage phiV10	negative
Escherichia virus K1E	negative
Enterobacteria phage K1F	negative
Vibriophage VP4	negative
Staphylococcus phage 66	positive
Pseudomonas phage phiKMV	negative
Bacillus virus GA1	positive
Pseudomonas phage F116	negative
Synechococcus phage P60	negative
Yersinia phage phiYeO3-12	negative
Streptococcus phage Cp-1	positive
Enterobacteria phage ST104	negative
Shigella phage Sf6	negative
Salmonella virus P22	negative
Vibrio phage VP2	negative
Myxococcus phage Mx8	negative
Vibrio phage VP5	negative
Burkholderia virus BcepC6B	negative
Pseudomonas phage PaP2	negative
Bordetella virus BPP1	negative
Enterobacteria phage T3	negative
Burkholderia virus Bcep22	negative
Yersinia phage phiA1122	negative
Xanthomonas phage Cf1c	negative
Pseudomonas phage PaP3	negative
Vibrio phage VpV262	negative
Stx2 converting phage II	negative
Roseobacter phage SIO1	negative
Escherichia Stx1 converting phage	negative
Salmonella virus SP6	negative
Streptococcus phage C1	positive
Salmonella phage epsilon15	negative
Staphylococcus phage P68	positive
Staphylococcus phage 44AHJD	positive
Pseudomonad phage gh-1	negative
Salmonella phage ST64T	negative
Bacillus virus B103	positive
Mycoplasma virus P1	negative
Salmonella phage HK620	negative
Salmonella phage Vi06	negative
Pseudomonas phage phiIBB-PF7A	negative
Pseudomonas phage phi15	negative
Vibrio phage ICP3	negative
Vibrio phage ICP2	negative
Salmonella phage ST160	negative
Vibrio phage VBP47	negative
Vibrio phage VBP32	negative
Synechococcus phage S-RIP1	negative
Synechococcus phage S-RIP2	negative
Synechococcus phage S-CBP42	negative
Synechococcus phage S-CBP4	negative
Pseudoalteromonas phage pYD6-A	negative
Sulfitobacter phage phiCB2047-B	negative
Pseudomonas phage LUZ7	negative
Pseudomonas phage LIT1	negative
Vibrio phage N4	negative
Klebsiella phage KP34	negative
Klebsiella phage KP32	negative
Pseudomonas phage phi-2	negative
Xylella phage Xfas53	negative
Salmonella phage g341c	negative
Hamiltonella virus APSE1	negative
