Abiotrophia defectiva	positive
Acaricomes phytoseiuli	positive
Acetitomaculum ruminis	positive
Acetivibrio cellulolyticus	negative
Acetivibrio ethanolgignens	negative
Acetivibrio multivorans	negative
Acetoanaerobium noterae	negative
Acetobacter aceti	negative
Acetobacter cerevisiae	negative
Acetobacter cibinongensis	negative
Acetobacter estunensis	negative
Acetobacter fabarum	negative
Acetobacter ghanensis	negative
Acetobacter indonesiensis	negative
Acetobacter lovaniensis	negative
Acetobacter malorum	negative
Acetobacter nitrogenifigens	negative
Acetobacter oeni	negative
Acetobacter orientalis	negative
Acetobacter orleanensis	negative
Acetobacter pasteurianus	negative
Acetobacter pornorurn	negative
Acetobacter senegalensis	negative
Acetobacter xylinus	negative
Acetobacterium bakii	positive
Acetobacterium carbinolicum	positive
Acetobacterium dehalogenans	positive
Acetobacterium fimetarium	positive
Acetobacterium malicum	positive
Acetobacterium paludosum	positive
Acetobacterium tundrae	positive
Acetobacterium wieringae	positive
Acetobacterium woodii	positive
Acetofilamentum rigidum	negative
Acetohalobium arabaticum	negative
Acetomicrobium faecale	negative
Acetomicrobium flavidum	negative
Acetonema longum	negative
Acetothermus paucivorans	negative
Acholeplasma axanthum	negative
Acholeplasma brassicae	negative
Acholeplasma cavigenitalium	negative
Acholeplasma equifetale	negative
Acholeplasma granularum	negative
Acholeplasma hippikon	negative
Acholeplasma laidlawii	negative
Acholeplasma modicum	negative
Acholeplasma morum	negative
Acholeplasma multilocale	negative
Acholeplasma oculi	negative
Acholeplasma palmae	negative
Acholeplasma parvum	negative
Acholeplasma pleciae	negative
Acholeplasma vituli	negative
Achromobacter denitrificans	negative
Achromobacter insolitus	negative
Achromobacter piechaudii	negative
Achromobacter ruhlandii	negative
Achromobacter spanius	negative
Acidaminobacter hydrogenoformans	negative
Acidaminococcus fermentans	negative
Acidaminococcus intestini	negative
Acidicaldus organivorans	negative
Acidimicrobium ferrooxidans	positive
Acidiphilium acidophilum	negative
Acidiphilium angustum	negative
Acidiphilium cryptum	negative
Acidiphilium multivorum	negative
Acidiphilium organovorum	negative
Acidiphilium rubrum	negative
Acidisoma sibiricum	negative
Acidisoma tundrae	negative
Acidisphaera rubrifaciens	negative
Acidithiobacillus albertensis	negative
Acidithiobacillus caldus	negative
Acidithiobacillus ferrooxidans	negative
Acidithiobacillus thiooxidans	negative
Acidobacterium capsulatum	negative
Acidocella aminolytica	negative
Acidocella facilis	negative
Acidomonas methanolica	negative
Acidothermus cellulolyticus	positive
Acidovorax anthurii	negative
Acidovorax caeni	negative
Acidovorax cattleyae	negative
Acidovorax citrulli	negative
Acidovorax defluvii	negative
Acidovorax delafieldii	negative
Acidovorax facilis	negative
Acidovorax konjaci	negative
Acidovorax temperans	negative
Acidovorax valerianellae	negative
Acinetobacter baumannii	negative
Acinetobacter baylyi	negative
Acinetobacter bouvetii	negative
Acinetobacter calcoaceticus	negative
Acinetobacter gerneri	negative
Acinetobacter haemolyticus	negative
Acinetobacter johnsonii	negative
Acinetobacter junii	negative
Acinetobacter lwoffi	negative
Acinetobacter parvus	negative
Acinetobacter radioresistens	negative
Acinetobacter schindleri	negative
Acinetobacter soli	negative
Acinetobacter tandoii	negative
Acinetobacter tjernbergiae	negative
Acinetobacter towneri	negative
Acinetobacter ursingii	negative
Acinetobacter venetianus	negative
Acrocarpospora corrugata	positive
Acrocarpospora macrocephala	positive
Acrocarpospora pleiomorpha	positive
Actibacter sediminis	negative
Actinoalloteichus cyanogriseus	positive
Actinoalloteichus hymeniacidonis	positive
Actinoalloteichus spitiensis	positive
Actinobacillus capsulatus	negative
Actinobacillus delphinicola	negative
Actinobacillus hominis	negative
Actinobacillus indolicus	negative
Actinobacillus lignieresii	negative
Actinobacillus minor	negative
Actinobacillus muris	negative
Actinobacillus pleuropneumoniae	negative
Actinobacillus porcinus	negative
Actinobacillus rossii	negative
Actinobacillus scotiae	negative
Actinobacillus seminis	negative
Actinobacillus succinogenes	negative
Actinobaccillus suis	negative
Actinobacillus ureae	negative
Actinobaculum massiliense	positive
Actinobaculum schaalii	positive
Actinobaculum suis	positive
Actinomyces urinale	positive
Actinocatenispora rupis	positive
Actinocatenispora thailandica	positive
Actinocatenispora sera	positive
Actinocorallia aurantiaca	positive
Actinocorallia aurea	positive
Actinocorallia cavernae	positive
Actinocorallia glomerata	positive
Actinocorallia herbida	positive
Actinocorallia libanotica	positive
Actinocorallia longicatena	positive
Actinomadura alba	positive
Actinomadura atramentaria	positive
Actinomadura bangladeshensis	positive
Actinomadura catellatispora	positive
Actinomadura chibensis	positive
Actinomadura chokoriensis	positive
Actinomadura citrea	positive
Actinomadura coerulea	positive
Actinomadura echinospora	positive
Actinomadura fibrosa	positive
Actinomadura formosensis	positive
Actinomadura hibisca	positive
Actinomadura kijaniata	positive
Actinomadura latina	positive
Actinomadura livida	positive
Actinomadura luteofluorescens	positive
Actinomadura macra	positive
Actinomadura madurae	positive
Actinomadura oligospora	positive
Actinomadura pelletieri	positive
Actinomadura rubrobrunea	positive
Actinomadura rugatobispora	positive
Actinomadura umbrina	positive
Actinomadura verrucosospora	positive
Actinomadura vinacea	positive
Actinomadura viridilutea	positive
Actinomadura viridis	positive
Actinomadura yumaensis	positive
Actinomyces bovis	positive
Actinomyces denticolens	positive
Actinomyces europaeus	positive
Actinomyces georgiae	positive
Actinomyces gerencseriae	positive
Actinomyces hordeovulneris	positive
Actinomyces howellii	positive
Actinomyces hyovaginalis	positive
Actinomyces israelii	positive
Actinomyces johnsonii	positive
Actinomyces meyeri	positive
Actinomyces naeslundii	positive
Actinomyces neuii	positive
Actinomyces odontolyticus	positive
Actinomyces oris	positive
Actinomyces radingae	positive
Actinomyces slackii	positive
Actinomyces turicensis	positive
Actinomyces viscosus	positive
Actinoplanes auranticolor	positive
Actinoplanes brasiliensis	positive
Actinoplanes consettensis	positive
Actinoplanes deccanensis	positive
Actinoplanes derwentensis	positive
Actinoplanes digitatis	positive
Actinoplanes durhamensis	positive
Actinoplanes ferrugineus	positive
Actinoplanes globisporus	positive
Actinoplanes humidus	positive
Actinoplanes italicus	positive
Actinoplanes liguriensis	positive
Actinoplanes lobatus	positive
Actinoplanes missouriensis	positive
Actinoplanes palleronii	positive
Actinoplanes philippinensis	positive
Actinoplanes rectilineatus	positive
Actinoplanes regularis	positive
Actinoplanes teichomyceticus	positive
Actinoplanes utahensis	positive
Actinopolyspora halophila	positive
Actinopolyspora mortivallis	positive
Actinosynnema mirum	positive
Actinotalea fermentans	positive
Aerococcus sanguinicola	positive
Aerococcus urinae	positive
Aerococcus urinaeequi	positive
Aerococcus urinaehominis	positive
Aerococcus viridans	positive
Aeromicrobium erythreum	positive
Aeromonas allosaccharophila	negative
Aeromonas bestiarum	negative
Aeromonas caviae	negative
Aeromonas encheleia	negative
Aeromonas enteropelogenes	negative
Aeromonas eucrenophila	negative
Aeromonas ichthiosmia	negative
Aeromonas jandaei	negative
Aeromonas media	negative
Aeromonas popoffii	negative
Aeromonas sobria	negative
Aeromonas veronii	negative
Agrobacterium gelatinovorum	negative
Agrococcus citreus	positive
Agrococcus jenensis	positive
Agromonas oligotrophica	negative
Agromyces fucosus	positive
Agromyces hippuratus	positive
Agromyces luteolus	positive
Agromyces mediolanus	positive
Agromyces ramosus	positive
Agromyces rhizospherae	positive
Akkermansia muciniphila	negative
Albidiferax ferrireducens	negative
Albidovulum inexpectatum	negative
Alcaligenes denitrificans	negative
Alcaligenes faecalis	negative
Alcanivorax borkumensis	negative
Alcanivorax jadensis	negative
Algicola bacteriolytica	negative
Alicyclobacillus disulfidooxidans	positive
Alicyclobacillus sendaiensis	positive
Alicyclobacillus vulcanalis	positive
Alishewanella fetalis	negative
Alkalibacillus haloalkaliphilus	positive
Alkalilimnicola ehrlichii	negative
Alkaliphilus oremlandii	positive
Alkaliphilus transvaalensis	positive
Allochromatium vinosum	negative
Alloiococcus otitis	positive
Allokutzneria albata	positive
Altererythrobacter ishigakiensis	negative
Altermonas haloplanktis	negative
Altermonas macleodii	negative
Alysiella crassa	negative
Alysiella filiformis	negative
Aminobacter aganoensis	negative
Aminobacter aminovorans	negative
Aminobacter niigataensis	negative
Aminobacterium mobile	negative
Aminomonas paucivorans	negative
Ammoniphilus oxalaticus	growth
Ammoniphilus oxalivorans	growth
Amphibacillus xylanus	positive
Amphritea balenae	negative
Amphritea japonica	negative
Amycolatopsis alba	positive
Amycolatopsis albidoflavus	positive
Amycolatopsis azurea	positive
Amycolatopsis coloradensis	positive
Amycolatopsis lurida	positive
Amycolatopsis mediterranei	positive
Amycolatopsis rifamycinica	positive
Amycolatopsis rubida	positive
Amycolatopsis sulphurea	positive
Amycolatopsis tolypomycina	positive
Anabaena cylindrica	negative
Anabaena flos-aquae	negative
Anabaena variabilis	negative
Anaeroarcus burkinensis	negative
Anaerobaculum mobile	negative
Anaerobiospirillum succiniciproducens	negative
Anaerobiospirillum thomasii	negative
Anaerococcus hydrogenalis	positive
Anaerococcus lactolyticus	positive
Anaerococcus prevotii	positive
Anaerococcus tetradius	positive
Anaerococcus vaginalis	positive
Anaerofustis stercorihominis	positive
Anaeromusa acidaminophila	negative
Anaeromyxobacter dehalogenans	negative
Anaerorhabdus furcosa	negative
Anaerosinus glycerini	negative
Anaerovirgula multivorans	positive
Ancalomicrobium adetum	negative
Ancylobacter aquaticus	negative
Aneurinibacillus aneurinilyticus	positive
Aneurinibacillus migulanus	positive
Aneurinibacillus thermoaerophilus	positive
Angiococcus disciformis	negative
Angulomicrobium tetraedrale	negative
Anoxybacillus pushchinoensis	positive
Aquabacterium commune	negative
Aquabacterium parvum	negative
Aquaspirillum polymorphum	negative
Aquaspirillum putridiconchylium	negative
Aquaspirillum serpens	negative
Aquimarina latercula	negative
Arcanobacterium haemolyticum	positive
Arcanobacterium pyogenes	positive
Archangium gephyra	negative
Arcobacter butzleri	negative
Arcobacter cryaerophilus	negative
Arcobacter halophilus	negative
Arcobacter nitrofigilis	negative
Arcobacter skirrowii	negative
Arhodomonas aquaeolei	negative
Arsenophonus nasoniae	negative
Arthrobacter agilis	positive
Arthrobacter albus	positive
Arthrobacter aurescens	positive
Arthrobacter chlorophenolicus	positive
Arthrobacter citreus	positive
Arthrobacter crystallopoietes	positive
Arthrobacter cumminsii	positive
Arthrobacter globiformis	positive
Arthrobacter histidinolovorans	positive
Arthrobacter ilicis	positive
Arthrobacter luteus	positive
Arthrobacter methylotrophus	positive
Arthrobacter mysorens	positive
Arthrobacter nicotianae	positive
Arthrobacter nicotinovorans	positive
Arthrobacter oxydans	positive
Arthrobacter pascens	positive
Arthrobacter phenanthrenivorans	positive
Arthrobacter polychromogenes	positive
Atrhrobacter protophormiae	positive
Arthrobacter psychrolactophilus	positive
Arthrobacter ramosus	positive
Arthrobacter sulfonivorans	positive
Arthrobacter sulfureus	positive
Arthrobacter uratoxydans	positive
Arthrobacter ureafaciens	positive
Arthrobacter viscosus	positive
Arthrobacter woluwensis	positive
Asaia bogorensis	negative
Asanoa ferruginea	positive
Asticcacaulis biprosthecium	negative
Asticcacaulis excentricus	negative
Atopobacter phocae	positive
Atopobium fossor	positive
Atopobium minutum	positive
Atopobium parvulum	positive
Atopobium rimae	positive
Atopobium vaginae	positive
Aureobacterium barkeri	positive
Aurobacterium liquefaciens	positive
Avibacterium avium	negative
Avibacterium gallinarum	negative
Avibacterium paragallinarum	negative
Avibacterium volantium	negative
Azoarcus indigens	negative
Azoarcus tolulyticus	negative
Azoarcus toluvorans	negative
Azohydromonas australica	negative
Azohydromonas lata	negative
Azomonas agilis	negative
Azomonas insignis	negative
Azomonas macrocytogenes	negative
Azorhizobium caulinodans	negative
Azorhizophilus paspali	negative
Azospirillum brasilense	negative
Azospirillum halopraeferens	negative
Azospirillum irakense	negative
Azotobacter beijerinckii	negative
Azotobacter chroococcum	negative
Azotobacter nigricans	negative
Azotobacter salinestris	negative
Azotobacter vinelandii	negative
Bacillus acidiceler	positive
Bacillus acidicola	positive
Bacillus agaradhaerens	positive
Bacillus aidingensis	positive
Bacillus akibai	positive
Bacillus alcalophilus	positive
Bacillus alkalidiazotrophicus	positive
Bacillus alkalitelluris	positive
Bacillus altitudinis	positive
Bacillus amyloliquefaciens	positive
Bacillus aneurinolyticus	positive
Bacillus aquaemaris	positive
Bacillus atrophaeus	positive
Bacillus azotoformans	positive
Bacillus badius	positive
Bacillus benzoevorans	positive
Bacillus brevis	positive
Bacillus caldolyticus	positive
Bacillus centrosporus	positive
Bacillus cereus	positive
Bacillus circulans	positive
Bacillus clarkii	positive
Bacillus coagulans	positive
Bacillus cohnii	positive
Bacillus fastidiosus	positive
Bacillus firmus	positive
Bacillus flexus	positive
Bacillus fusiformis	positive
Bacillus galactophilus	positive
Bacillus gibsonii	positive
Bacillus globigii	positive
Bacillus halmapalus	positive
Bacillus halodurans	positive
Bacillus horikoshii	positive
Bacillus horti	positive
Bacillus laterosporus	positive
Bacillus lentus	positive
Bacillus licheniformis	positive
Bacillus megaterium	positive
Bacillus methanolicus	positive
Bacillus mojavensis	positive
Bacillus mycoides	positive
Bacillus nealsonii	positive
Bacillus oleronius	positive
Bacillus pantothenticus	positive
Bacillus patagoniensis	positive
Bacillus pseudalcaliphilus	positive
Bacillus pseudofirmus	positive
Bacillus psychrodurans	positive
Bacillus psychrosaccharolyticus	positive
Bacillus pumilus	positive
Bacillus safensis	positive
Bacillus schlegelii	positive
Bacillus selenitireducens	positive
Bacillus simplex	positive
Bacillus smithii	positive
Bacillus sphaericus	positive
Bacillus stearothermophilus	positive
Bacillus stratosphericus	positive
Bacillus subterraneus	positive
Bacillus subtilis	positive
Bacillus tequilensis	positive
Bacillus thermoantarcticus	positive
Bacillus thermocloacae	positive
Bacillus thermoglucosidasius	positive
Bacteriovorax stolpii	negative
Bacteroides caccae	negative
Bacteroides coagulans	negative
Bacteroides eggerthii	negative
Bacteroides fragilis	negative
Bacteroides galacturonicus	negative
Bacteroides helcogenes	negative
Bacteroides ovatus	negative
Bacteroides pectinophilus	negative
Bacteroides pyogenes	negative
Bacteroides salyersiae	negative
Bacteroides stercoris	negative
Bacteroides suis	negative
Bacteroides tectus	negative
Bacteroides thetaiotaomicron	negative
Bacteroides uniformis	negative
Bacteroides ureolyticus	negative
Bacteroides vulgatus	negative
Balnearium lithotrophicum	negative
Balneatrix alpica	negative
Balneola vulgaris	negative
Barnesiella viscericola	negative
Bartonella alsatica	negative
Bartonella bacilliformis	negative
Bartonella clarridgeiae	negative
Bartonella doshiae	negative
Bartonella elizabethae	negative
Bartonella grahamii	negative
Bartonella henselae	negative
Bartonella rochalimae	negative
Bartonella vinsonii	negative
Bavariicoccus seileri	positive
Bdellovibrio bacteriovorus	negative
Bdellovibrio exovorus	negative
Beggiatoa alba	negative
Beijerinckia derxii	negative
Beijerinckia fluminensis	negative
Beijerinckia indica	negative
Beijerinckia mobilis	negative
Belliella baltica	negative
Bellilinea caldifistulae	negative
Belnapia moabensis	negative
Bergeriella denitrificans	negative
Beutenbergia cavernae	positive
Bibersteinia trehalosi	negative
Bifidobacterium adolescentis	positive
Bifidobacterium angulatum	positive
Bifidobacterium animalis	positive
Bifidobacterium asteroides	positive
Bifidobacterium bifidum	positive
Bifidobacterium boum	positive
Bifidobacterium breve	positive
Bifidobacterium catenulatum	positive
Bifidobacterium choerinum	positive
Bifidobacterium coryneforme	positive
Bifidobacterium cuniculi	positive
Bifidobacterium dentium	positive
Bifidobacterium gallicum	positive
Bifidobacterium gallinarum	positive
Bifidobacterium indicum	positive
Bifidobacterium longum	positive
Bifidobacterium magnum	positive
Bifidobacterium merycicum	positive
Bifidobacterium minimum	positive
Bifidobacterium pseudocatenulatum	positive
Bifidobacterium pseudolongum	positive
Bifidobacterium pullorum	positive
Bifidobacterium ruminantium	positive
Bifidobacterium saeculare	positive
Bifidobacterium subtile	positive
Bifidobacterium thermophilum	positive
Bilophila wadsworthia	negative
Biostraticola tofi	negative
Bizionia argentinensis	negative
Blastobacter capsulatus	negative
Blastobacter denitrificans	negative
Blastococcus aggregatus	positive
Blastococcus saxobsidens	positive
Blastochloris viridis	negative
Blastomonas natatoria	positive
Blastopirellula marina	negative
Blautia coccoides	positive
Blautia hansenii	positive
Blautia producta	positive
Blautia wexlerae	positive
Bogoriella caseilytica	positive
Bordetella avium	negative
Bordetella bronchiseptica	negative
Bordetella hinzii	negative
Bordetella holmesii	negative
Bordetella parapertussis	negative
Bordetella pertussis	negative
Bordetella petrii	negative
Bordetella trematum	negative
Borrelia afzelii	negative
Borrelia americana	negative
Borrelia burgdorferi	negative
Borrelia carolinensis	negative
Borrelia coriaceae	negative
Borrelia garinii	negative
Borrelia japonica	negative
Bosea minatitlanensis	negative
Bosea thiooxidans	negative
Brachybacterium alimentarium	positive
Brachybacterium faecium	positive
Brachybacterium paraconglomeratum	positive
Brachybacterium rhamnosum	positive
Brachybacterium tyrofermentans	positive
Brachyspira alvinipulli	negative
Brachyspira hyodysenteriae	negative
Brachyspira innocens	negative
Brachyspira murdochii	negative
Brachyspira pilosicoli	negative
Bradyrhizobium canariense	negative
Bradyrhizobium elkanii	negative
Bradyrhizobium japonicum	negative
Bradyrhizobium liaoningense	negative
Brenneria alni	negative
Brenneria nigrifluens	negative
Brenneria quercina	negative
Brenneria quercina	negative
Brenneria salicis	negative
Brevibacillus agri	negative
Brevibacillus borstelensis	negative
Brevibacillus brevis	positive
Brevibacillus centrosporus	positive
Brevibacillus choshinensis	negative
Brevibacillus invocatus	negative
Brevibacillus laterosporus	positive
Brevibacillus parabrevis	negative
Brevibacillus reuszeri	negative
Brevibacterium abidum	positive
Brevibacterium album	positive
Brevibacterium aurantiacum	positive
Brevibacterium celere	positive
Brevibacterium epidermidis	positive
Brevibacterium frigoritolerans	positive
Brevibacterium halotolerans	positive
Brevibacterium iodinum	positive
Brevibacterium linens	positive
Brevibacterium lyticum	positive
Brevibacterium mcbrellneri	positive
Brevibacterium otitidis	positive
Brevibacterium oxydans	positive
Brevibacterium paucivorans	positive
Brevibacterium stationis	positive
Brevinema andersonii	negative
Brevundimonas alba	negative
Brevundimonas aurantiaca	negative
 Brevundimonas diminuta	negative
Brevundimonas intermedia	negative
Brevundimonas subvibrioides	negative
Brevundimonas vancanneytii	negative
Brevundimonas variabilis	negative
Brevundimonas vesicularis	negative
Brochothrix campestris	positive
Brochothrix thermosphacta	positive
Brucella canis	negative
Brucella neotomae	negative
Bryobacter aggregatus	negative
Burkholderia ambifaria	negative
Burkholderia andropogonis	negative
Burkholderia anthina	negative
Burkholderia caledonica	negative
Burkholderia caryophylli	negative
Burkholderia cenocepacia	negative
Burkholderia cepacia	negative
Burkholderia cocovenenans	negative
Burkholderia dolosa	negative
Burkholderia fungorum	negative
Burkholderia glathei	negative
Burkholderia glumae	negative
Burkholderia graminis	negative
Burkholderia kururiensis	negative
Burkholderia multivorans	negative
Burkholderia phenazinium	negative
Burkholderia plantarii	negative
Burkholderia pyrrocinia	negative
Burkholderia silvatlantica	negative
Burkholderia stabilis	negative
Burkholderia thailandensis	negative
Burkholderia tropica	negative
Burkholderia unamae	negative
Burkholderia vietnamiensis	negative
Buttiauxella agrestis	negative
Buttiauxella brennerae	negative
Buttiauxella ferragutiae	negative
Buttiauxella gaviniae	negative
Buttiauxella izardii	negative
Buttiauxella noackiae	negative
Buttiauxella warmboldiae	negative
Butyrivibrio fibrisolvens	negative
Butyrivibrio hungatei	negative
Butyrivibrio proteoclasticus	negative
Caenimonas koreensis	negative
Caldalkalibacillus uzonensis	positive
Caldanaerobacter subterraneus	positive
Caldanaerobius fijiensis	unknown
Caldanaerobius polysaccharolyticus	negative
Caldanaerobius zeae	negative
Caldanaerovirga acetigignens	negative
Caldicellulosiruptor bescii	positive
Caldicellulosiruptor kristjanssonii	positive
Caldicellulosiruptor owensensis	positive
Campylobacter coli	negative
Campylobacter concisus	negative
Campylobacter curvus	negative
Campylobacter fetus	negative
Campylobacter gracilis	negative
Campylobacter helveticus	negative
Campylobacter hominis	negative
Campylobacter hyointestinalis	negative
Campylobacter jejuni	negative
Campylobacter lari	negative
Campylobacter mucosalis	negative
Campylobacter rectus	negative
Campylobacter showae	negative
Campylobacter sputorum	negative
Campylobacter upsaliensis	negative
Capnocytophaga canimorsus	negative
Capnocytophaga cynodegmi	negative
Capnocytophaga gingivalis	negative
Capnocytophaga granulosa	negative
Capnocytophaga haemolytica	negative
Capnocytophaga ochracea	negative
Capnocytophaga sputigena	negative
Cardiobacterium hominis	negative
Carnimonas nigrificans	negative
Carnobacterium alterfunditum	positive
Carnobacterium divergens	positive
Carnobacterium funditum	positive
Carnobacterium gallinarum	positive
Carnobacterium maltaromaticum	positive
Carnobacterium mobile	positive
Carnobacterium viridans	positive
Caryophanon latum	positive
Caryophanon tenue	positive
Catellatospora citrea	positive
Catellatospora methionotrophica	positive
Catenococcus thiocycli	positive
Catenuloplanes atrovinosus	positive
Catenuloplanes castaneus	positive
Catenuloplanes crispus	positive
Catenuloplanes indicus	positive
Catenuloplanes japonicus	positive
Catenuloplanes nepalensis	positive
Catenuloplanes niger	positive
Chryseobacterium balustinum	negative
Citrobacter freundii	negative
Clostridium acetobutylicum	positive
Clostridium formicoaceticum	positive
Clostridium sporogenes	positive
Coccochloris elabens	unknown
Corynebacterium flavescens	positive
Corynebacterium variabile	positive
Curtobacterium albidum	positive
Curtobacterium citreus	positive
Dactylosporangium aurantiacum	positive
Dactylosporangium fulvum	positive
Dactylosporangium matsuzakiense	positive
Dactylosporangium roseum	positive
Dactylosporangium thailandense	positive
Dactylosporangium vinaceum	positive
Deinococcus aerius	unknown
Deinococcus apachensis	unknown
Deinococcus aquaticus	unknown
Deinococcus aquatilis	unknown
Deinococcus caeni	unknown
Deinococcus radiodurans	positive
Deinococcus radiophilus	positive
Delftia acidovorans	negative
Desulfovibrio desulfuricans	negative
Diplococcus pneumoniae	positive
Echinicola pacifica	negative
Echinicola vietnamensis	negative
Enterobacter aerogenes	negative
Enterobacter amnigenus	negative
Enterobacter asburiae	negative
Enterobacter cancerogenus	negative
Enterobacter cloacae	negative
Enterobacter gergoviae	negative
Enterobacter helveticus	negative
Enterobacter hormaechei	negative
Enterobacter kobei	negative
Enterobacter ludwigii	negative
Enterococcus durans	positive
Enterococcus faecalis	positive
Enterococcus faecium	positive
Erwinia hapontici	negative
Escherichia coli	negative
Faecalibacterium prausnitzii	negative
Fangia hongkongensis	negative
Fastidiosipila sanguinis	positive
Flavobacterium antarcticum	negative
Flavobacterium aquatile	negative
Flavobacterium aquidurense	negative
Flavobacterium balustinum	negative
Flavobacterium croceum	negative
Flavobacterium cucumis	negative
Flavobacterium daejeonense	negative
Flavobacterium defluvii	negative
Flavobacterium degerlachei	negative
Flavobacterium denitrificans	negative
Flavobacterium filum	negative
Flavobacterium flevense	negative
Flavobacterium frigidarium	negative
Flavobacterium mizutaii	negative
Flavobacterium okeanokoites	negative
Fusobacterium nucleatum	negative
Gaetbulibacter saemankumensis	negative
Gallibacterium anatis	negative
Gallicola barnesae	positive
Garciella nitratireducens	positive
Geobacillus thermoglucosidasius	positive
Geobacillus stearothermophilus	positive
Geobacter bemidjiensis	negative
Geobacter bremensis	negative
Geobacter chapellei	negative
Geobacter grbiciae	negative
Geobacter hydrogenophilus	negative
Geobacter lovleyi	negative
Geobacter metallireducens	negative
Geobacter pelophilus	negative
Geobacter pickeringii	negative
Geobacter sulfurreducens	negative
Geodermatophilus obscurus	positive
Gluconacetobacter xylinus	negative
Gordonia rubripertincta	positive
Haemophilus aegyptius	negative
Haemophilus aphrophilus	negative
Haemophilus felis	negative
Haemophilus gallinarum	negative
Haemophilus haemolyticus	negative
Haemophilus influenzae	negative
Haemophilus paracuniculus	negative
Haemophilus parahaemolyticus	negative
Haemophilus parainfluenzae	negative
Haemophilus paraphrohaemolyticus	negative
Haemophilus parasuis	negative
Haemophilus pittmaniae	negative
Hafnia alvei	negative
Hahella ganghwensis	negative
Halalkalibacillus halophilus	positive
Helicobacter pylori	negative
Ideonella azotifigens	negative
Idiomarina abyssalis	negative
Idiomarina baltica	negative
Idiomarina fontislapidosi	negative
Idiomarina loihiensis	negative
Idiomarina ramblicola	negative
Idiomarina seosinensis	negative
Idiomarina zobellii	negative
Ignatzschineria larvae	negative
Ignavigranum ruoffiae	positive
Ilumatobacter fluminis	positive
Ilyobacter delafieldii	negative
Ilyobacter insuetus	negative
Ilyobacter polytropus	negative
Ilyobacter tartaricus	negative
Janibacter anophelis	positive
Janibacter corallicola	positive
Janibacter limosus	positive
Janibacter melonis	positive
Janibacter terrae	positive
Jannaschia cystaugens	negative
Jannaschia helgolandensis	negative
Jannaschia pohangensis	negative
Jannaschia rubra	negative
Janthinobacterium agaricidamnosum	negative
Janthinobacterium lividum	negative
Jejuia pallidilutea	negative
Jeotgalibacillus alimentarius	variable
Jeotgalicoccus halotolerans	positive
Kaistia adipata	negative
Kaistia soli	negative
Kangiella aquimarina	negative
Kangiella koreensis	negative
Kerstersia gyiorum	negative
Kiloniella laminariae	negative
Klebsiella pneumonia	negative
Kluyvera ascorbata	negative
Kocuria roasea	positive
 Kocuria varians	positive
Kurthia zopfii	positive
Labedella gwakjiensis	positive
Labrenzia aggregata	negative
Labrenzia alba	negative
Labrenzia alexandrii	negative
Labrenzia marina	negative
Labrys methylaminiphilus	negative
Labrys miyagiensis	negative
Labrys monachus	negative
Labrys okinawensis	negative
Labrys portucalensis	negative
Laceyella putida	positive
Lechevalieria aerocolonigenes	positive
Listeria welshimeri	positive
Listonella anguillarum	negative
Macrococcus bovicus	positive
Marinobacter algicola	negative
Marinobacter bryozoorum	negative
Marinobacter flavimaris	negative
Meiothermus ruber	negative
Methylophilus methylotrophus	negative
Microbacterium ammoniaphilum	positive
Microbacterium arborescens	positive
Microbacterium liquefaciens	positive
Microbacterium oxydans	positive
Micrococcus luteus	positive
Micrococcus lylae	positive
Moraxella bovis	negative
Moraxella nonliquefaciens	negative
Moraxella osloensis	negative
Nakamurella multipartita	positive
Nannocystis pusilla	negative
Natranaerobius thermophilus	positive
Natranaerobius trueperi	positive
Naxibacter alkalitolerans	negative
Neisseria cinerea	negative
Neisseria denitrificans	negative
Neisseria gonorrhoeae	negative
Neisseria lactamica	negative
Neisseria mucosa	negative
Neisseria sicca	negative
Neisseria subflava	negative
Neptunomonas japonica	negative
Nesterenkonia holobia	positive
Nocardia argentinensis	positive
Nocardia corallina	positive
Nocardia otitidiscaviarum	positive
Oceanibulbus indolifex	negative
Oceanicaulis alexandrii	negative
Oceanicola batsensis	negative
Oceanicola granulosus	negative
Oceanicola nanhaiensis	negative
Oceanimonas baumannii	negative
Oceaniserpentilla haliotis	negative
Oceanisphaera donghaensis	negative
Oceanisphaera litoralis	negative
Oceanithermus desulfurans	negative
Oceanithermus profundus	negative
Oceanobacillus caeni	positive
Oceanospirillum linum	negative
Paenibacillus thiaminolyticus	positive
Paenibacillus larvae	positive
Pantoea agglomerans	negative
Paracoccus alcaliphilus	negative
Paucimonas lemoignei	negative
Planococcus citreus	positive
Planomicrobium okeanokoites	negative
Plesiomonas shigelloides	negative
Proteus vulgaris	negative
Providencia stuartii	negative
Pseudomonas aeruginosa	negative
Pseudomonas alcaligenes	negative
Pseudomonas anguillispetica	negative
Pseudomonas fluorescens	negative
Pseudoalteromonas haloplanktis	negative
Pseudomonas mendocina	negative
Pseudomonas pseudoalcaligenes	negative
Pseudomonas putida	negative
Pseudomonas tutzeri	negative
Pseudomonas syringae	negative
Psychrobacter faecalis	negative
Psychrobacter phenylpyruvicus	negative
Quadrisphaera granulorum	positive
Quatrionicoccus australiensis	unknown
Quinella ovalis	negative
Ralstonia insidiosa	negative
Ralstonia mannitolilytica	negative
Ralstonia pickettii	negative
Ramlibacter henchirensis	negative
Ramlibacter tataouinensis	negative
Raoultella ornithinolytica	negative
Raoultella planticola	negative
Raoultella terrigena	negative
Rathayibacter caricis	positive
Rathayibacter festucae	positive
Rathayibacter iranicus	positive
Rathayibacter rathayi	positive
Rathayibacter toxicus	positive
Rathayibacter tritici	positive
Rhodobacter sphaeroides	negative
Ruegeria gelatinovorans	negative
Saccharococcus thermophilus	positive
Saccharomonospora azurea	positive
Saccharomonospora cyanea	positive
Saccharomonospora viridis	negative
Saccharophagus degradans	negative
Saccharopolyspora erythraea	positive
Saccharopolyspora gregorii	positive
Saccharopolyspora hirsuta	positive
Saccharopolyspora hordei	positive
Saccharopolyspora rectivirgula	positive
Saccharopolyspora spinosa	positive
Saccharopolyspora taberi	positive
Saccharothrix australiensis	positive
Saccharothrix coeruleofusca	positive
Saccharothrix espanaensis	positive
Saccharothrix longispora	positive
Saccharothrix mutabilis	positive
Saccharothrix syringae	positive
Saccharothrix tangerinus	positive
Saccharothrix texasensis	positive
Sagittula stellata	negative
Salegentibacter salegens	negative
Salimicrobium album	positive
Salinibacter ruber	negative
Salinicoccus alkaliphilus	positive
Salinicoccus hispanicus	positive
Salinicoccus roseus	positive
Salinispora arenicola	positive
Salinispora tropica	positive
Salinivibrio costicola	negative
Salmonella bongori	negative
Salmonella enterica	negative
Salmonella subterranea	negative
Salmonella typhi	negative
Sanguibacter keddieii	positive
Sanguibacter suarezii	positive
Saprospira grandis	negative
Sarcina maxima	positive
Sarcina ventriculi	positive
Sebaldella termitidis	negative
Serratia fonticola	negative
Serratia marcescens	negative
Sphaerotilus natans	negative
Sphingobacterium multivorum	negative
Staphylococcus arlettae	positive
Staphylococcus aureus	positive
Staphylococcus cohnii	positive
Staphylococcus warneri	positive
Stenotrophomonas maltophilia	negative
Streptococcus faecalis	positive
Streptococcus milleri	positive
Streptococcus pneumoniae	positive
Streptomyces achromogenes	positive
Streptomyces cesalbus	positive
Streptomyces cescaepitosus	positive
Streptomyces cesdiastaticus	positive
Streptomyces cesexfoliatus	positive
Streptomyces fimbriatus	positive
Streptomyces fradiae	positive
Streptomyces fulvissimus	positive
Streptomyces griseoruber	positive
Streptomyces griseus	positive
Streptomyces lavendulae	positive
Streptomyces phaeochromogenes	positive
Streptomyces thermodiastaticus	positive
Streptomyces tubercidicus	positive
Tatlockia maceachernii	negative
Tatlockia micdadei	negative
Tenacibaculum amylolyticum	negative
Tenacibaculum discolor	negative
Tenacibaculum gallaicum	negative
Tenacibaculum lutimaris	negative
Tenacibaculum mesophilum	negative
Tenacibaculum skagerrakense	negative
Tepidanaerobacter syntrophicus	negative
Tepidibacter formicigenes	positive
Tepidibacter thalassicus	positive
Thermus aquaticus	negative
Thermus filiformis	negative
Thermus thermophilus	negative
Uliginosibacterium gangwonense	negative
Ulvibacter litoralis	negative
Umezawaea tangerina	positive
Undibacterium pigrum	negative
Ureaplasma urealyticum	negative
Ureibacillus composti	negative
Ureibacillus suwonensis	negative
Ureibacillus terrenus	negative
Ureibacillus thermophilus	negative
Ureibacillus thermosphaericus	negative
Vagococcus carniphilus	positive
Vagococcus elongatus	positive
Vagococcus fessus	positive
Vagococcus fluvialis	positive
Vagococcus lutrae	positive
Vagococcus salmoninarum	positive
Variovorax boronicumulans	negative
Variovorax dokdonensis	negative
Variovorax paradoxus	negative
Variovorax soli	negative
Veillonella atypica	negative
Veillonella caviae	negative
Veillonella criceti	negative
Veillonella dispar	negative
Veillonella montpellierensis	negative
Veillonella parvula	negative
Veillonella ratti	negative
Veillonella rodentium	negative
Venenivibrio stagnispumantis	negative
Verminephrobacter eiseniae	negative
Verrucomicrobium spinosum	negative
Vibrio aerogenes	negative
Vibrio aestuarianus	negative
Vibrio albensis	negative
Vibrio alginolyticus	negative
Vibrio campbellii	negative
Vibrio cholerae	negative
Vibrio cincinnatiensis	negative
Vibrio coralliilyticus	negative
Vibrio cyclitrophicus	negative
Vibrio diazotrophicus	negative
Vibrio fluvialis	negative
Vibrio furnissii	negative
Vibrio gazogenes	negative
Vibrio halioticoli	negative
Vibrio harveyi	negative
Vibrio ichthyoenteri	negative
Vibrio mediterranei	negative
Vibrio metschnikovii	negative
Vibrio mytili	negative
Vibrio natriegens	negative
Vibrio navarrensis	negative
Vibrio nereis	negative
Vibrio nigripulchritudo	negative
Vibrio ordalii	negative
Vibrio orientalis	negative
Vibrio parahaemolyticus	negative
Vibrio pectenicida	negative
Vibrio penaeicida	negative
Vibrio proteolyticus	negative
Vibrio shilonii	negative
Vibrio splendidus	negative
Vibrio tubiashii	negative
Vibrio vulnificus	negative
Virgibacillus halodenitrificans	positive
Virgibacillus pantothenticus	positive
Weissella cibaria	positive
Weissella confusa	positive
Weissella halotolerans	positive
Weissella hellenica	positive
Weissella kandleri	positive
Weissella koreensis	positive
Weissella minor	positive
Weissella paramesenteroides	positive
Weissella soli	positive
Weissella thailandensis	positive
Weissella viridescens	positive
Williamsia marianensis	positive
Williamsia maris	positive
Williamsia serinedens	positive
Winogradskyella thalassocola	negative
Wolbachia persica	negative
Wolinella succinogenes	negative
Xanthobacter agilis	negative
Xanthobacter aminoxidans	negative
Xanthobacter autotrophicus	negative
Xanthobacter flavus	negative
Xanthobacter tagetidis	negative
Xanthobacter viscosus	negative
Xanthomonas albilineans	negative
Xanthomonas alfalfae	negative
Xanthomonas arboricola	negative
Xanthomonas axonopodis	negative
Xanthomonas campestris	negative
Xanthomonas citri	negative
Xanthomonas codiaei	negative
Xanthomonas cucurbitae	negative
Xanthomonas euvesicatoria	negative
Xanthomonas fragariae	negative
Xanthomonas fuscans	negative
Xanthomonas gardneri	negative
Xanthomonas hortorum	negative
Xanthomonas hyacinthi	negative
Xanthomonas perforans	negative
Xanthomonas phaseoli	negative
Xanthomonas pisi	negative
Xanthomonas populi	negative
Xanthomonas theicola	negative
Xanthomonas translucens	negative
Xanthomonas vesicatoria	negative
Xenophilus azovorans	negative
Xenorhabdus beddingii	negative
Xenorhabdus bovienii	negative
Xenorhabdus cabanillasii	negative
Xenorhabdus doucetiae	negative
Xenorhabdus griffiniae	negative
Xenorhabdus hominickii	negative
Xenorhabdus koppenhoeferi	negative
Xenorhabdus nematophila	negative
Xenorhabdus poinarii	negative
Xylanibacter oryzae	negative
Xylanibacterium ulmi	positive
Xylella fastidiosa	negative
Xylophilus ampelinus	negative
Yangia pacifica	negative
Yaniella flava	positive
Yaniella halotolerans	positive
Yeosuana aromativorans	negative
Yersinia aldovae	negative
Yersinia bercovieri	negative
Yersinia enterocolitica	negative
Yersinia entomophaga	negative
Yersinia frederiksenii	negative
Yersinia intermedia	negative
Yersinia kristensenii	negative
Yersinia mollaretii	negative
Yersinia philomiragia	negative
Yersinia pseudotuberculosis	negative
Yersinia rohdei	negative
Yersinia ruckeri	negative
Yokenella regensburgei	negative
Yonghaparkia alkaliphila	positive
Zavarzinia compransoris	negative
Zeaxanthinibacter enoshimensis	negative
Zhihengliuella halotolerans	positive
Zobellella denitrificans	negative
Zobellella taiwanensis	negative
Zobellia galactanivorans	negative
Zobellia uliginosa	negative
Zoogloea ramigera	negative
Zoogloea resiniphila	negative
Zooshikella ganghwensis	negative
Zunongwangia profunda	negative
Zymobacter palmae	negative
Zymomonas mobilis	negative
Zymophilus paucivorans	negative
Zymophilus raffinosivorans	negative
