Methylobacillus	negative
Actinobaccillus	negative
Laribacter	negative
Ornithinibacillus	positive
Caldanaerobacter	positive
Alkalilimnicola	negative
Johnsonella	negative
Thiodictyon	negative
Pusillimonas	negative
Teredinibacter	negative
Herminiimonas	negative
Yersinia	negative
Aggregatibacter	negative
Phaeobacter	negative
SAR202	negative
Arcanobacterium	positive
Caulobacter	negative
Eubacterium	positive
Anaerofustis	positive
Desulfotalea	negative
Succinatimonas	negative
Wolinella	negative
Roseburia	positive
Zooshikella	negative
Labrys	negative
Alicycliphilus	negative
Thioalkalimicrobium	negative
Prochlorothrix	negative
Blastopirellula	negative
Pelobacter	negative
Cryptobacterium	positive
Western	positive
Unknown	unknown
Saccharococcus	positive
Leptolyngbya	negative
Flavonifractor	positive
Rhodanobacter	negative
Brochothrix	positive
Geminocystis	negative
Naxibacter	negative
Marinomonas	negative
Planococcus	positive
Azohydromonas	negative
Desulfobulbus	negative
Croceibacter	negative
Afipia	negative
Desulfonema	negative
Eggerthella	positive
Gloeobacter	negative
Oceanimonas	negative
Promicromonospora	positive
Hylemonella	negative
Solibacillus	positive
Desulfomonile	negative
Pontibacter	negative
Lactobacillus	positive
Bdellovibrio	negative
Marinobacter	negative
Acidaminobacter	negative
Bergeyella	negative
Salinisphaera	negative
Planctomyces	negative
Actinobacillus	negative
Akkermansia	negative
Desmospora	positive
Parvimonas	positive
Eikenella	negative
Agromyces	positive
Bordetella	negative
Haliangium	negative
Flavobacterium	negative
Capnocytophaga	negative
Klebsiella	negative
Chromohalobacter	negative
Heliothrix	negative
Belnapia	negative
Mesorhizobium	negative
Pedobacter	negative
Chlorobium	negative
Barnesiella	negative
Caldalkalibacillus	positive
Aquimarina	negative
Fulvimarina	negative
Aneurinibacillus	positive
Caenimonas	negative
Nitratiruptor	negative
Microscilla	negative
Granulibacter	negative
Sulfurospirillum	negative
Verrucosispora	positive
Zavarzinia	negative
Thermovibrio	negative
Alysiella	negative
Turicibacter	positive
Dethiobacter	positive
Thiocystis	negative
Cardiobacterium	negative
Plectonema	negative
Escherichia	negative
Echinicola	negative
butyrate-producing	positive
Methylocaldum	negative
Runella	negative
Gallionella	negative
Thermincola	positive
Rhodopirellula	negative
Microlunatus	positive
Oscillochloris	negative
Nodularia	negative
Sutterella	negative
Thermodesulfobium	negative
Dermocarpa	negative
Enhydrobacter	negative
Lactococcus	positive
Albidiferax	negative
Salinispora	positive
Amycolicicoccus	positive
Agromonas	negative
Cellvibrio	negative
Megasphaera	negative
Bulleidia	positive
Aurobacterium	positive
Wolbachia	negative
Tetrathiobacter	negative
Propionimicrobium	positive
Rahnella	negative
Thioflavicoccus	negative
Agrococcus	positive
Geothrix	negative
Peptococcus	positive
Aromatoleum	negative
Ureibacillus	negative
Solobacterium	positive
Methylomicrobium	negative
Nocardioidaceae	positive
Bergeriella	negative
Gramella	negative
SAR324	negative
Sphingomonas	negative
Rhodococcus	positive
Hoeflea	negative
Arthrospira	negative
Paraeggerthella	positive
Isosphaera	negative
Brachybacterium	positive
Anaerostipes	positive
Leuconostoc	positive
Xenophilus	negative
Azorhizobium	negative
Streptacidiphilus	positive
Bacteroides	negative
Nitrosococcus	negative
Serinicoccus	positive
Desulfobacterium	negative
Desulfonatronospira	negative
Coprothermobacter	negative
Xanthobacter	negative
Streptococcus	positive
Syntrophothermus	negative
Dehalogenimonas	negative
Catenococcus	positive
Psychromonas	negative
Renibacterium	positive
Parvibaculum	negative
Isoptericola	positive
Cylindrospermopsis	negative
Anaeroarcus	negative
Yaniella	positive
Peptoniphilus	positive
Vibrionales	negative
Quadrisphaera	positive
Arsenophonus	negative
Aureobacterium	positive
Thiothrix	negative
Saccharothrix	positive
Starkeya	negative
Altermonas	negative
Oligotropha	negative
Rhodovulum	negative
Rhizobium	negative
Leclercia	negative
Persephonella	negative
Ilumatobacter	positive
Mucilaginibacter	negative
Pseudoflavonifractor	negative
Coxiella	negative
Desulfuromonas	negative
Abiotrophia	positive
Hahella	negative
Myxococcus	negative
Ferrimonas	negative
Thermosinus	negative
Halothece	negative
Spirosoma	negative
Conexibacter	positive
Bogoriella	positive
Salinicoccus	positive
Kingella	negative
Alteromonas	negative
Hyphomonas	negative
Calothrix	negative
Odoribacter	negative
Magnetospirillum	negative
Rivularia	negative
Plesiomonas	negative
Cellulophaga	negative
Oceanibulbus	negative
Chryseobacterium	negative
SAR	negative
Photobacterium	negative
Mahella	positive
Jeotgalicoccus	positive
Nakamurella	positive
Rhodopseudomonas	negative
Ammoniphilus	growth
Stenotrophomonas	negative
Thermaerobacter	positive
Acidobacterium	negative
Algicola	negative
Acidaminococcus	negative
Spirochaeta	negative
Delftia	negative
Olsenella	positive
Thermoanaerobacter	positive
Dialister	negative
Kribbella	positive
Anaeromyxobacter	negative
Geodermatophilus	positive
Moorella	positive
Cytophaga	negative
Actinomyces	positive
Psychroflexus	negative
Chroococcidiopsis	negative
Amycolatopsis	positive
Fervidobacterium	negative
Actinomadura	positive
Xylanimonas	positive
Erythrobacter	negative
Thermosynechococcus	negative
Amphritea	negative
Thermobrachium	positive
Geobacter	negative
Hymenobacter	negative
Erysipelotrichaceae	positive
Sagittula	negative
Salinibacter	negative
Leadbetterella	negative
Slackia	positive
Amphibacillus	positive
Coriobacterium	positive
Wigglesworthia	negative
Halothiobacillus	negative
Beutenbergia	positive
Gemella	positive
Umezawaea	positive
Exiguobacterium	positive
Heliobacterium	negative
Kiloniella	negative
Halobacteroides	negative
Allochromatium	negative
Ethanoligenens	positive
Caldanaerobius	negative
Jonesia	positive
Paludibacter	negative
Gloeothece	negative
Salinivibrio	negative
Tannerella	negative
Alistipes	negative
Kordia	negative
Kerstersia	negative
Parachlamydia	negative
Acetivibrio	negative
Aminobacter	negative
Ewingella	negative
Jejuia	negative
Rhodothermus	negative
Thermanaeromonas	positive
Alkaliflexus	negative
Ruegeria	negative
Biostraticola	negative
Micrococcus	positive
Campylobacterales	negative
Salimicrobium	positive
Acetofilamentum	negative
Anaerovirgula	positive
Acinetobacter	negative
Marivirga	negative
Lacinutrix	negative
Riemerella	negative
Desulfatibacillum	negative
Herbaspirillum	negative
Gemmata	negative
Alcaligenes	negative
Sulfurovum	negative
Thiobacillus	negative
Desulfosarcina	negative
Thauera	negative
Beggiatoa	negative
Phenylobacterium	negative
Sphaerobacter	negative
Dermacoccus	positive
Pseudovibrio	negative
Mesoplasma	positive
Peptostreptococcus	positive
Pseudoxanthomonas	negative
Niabella	negative
Mesoflavibacter	negative
Desulfarculus	negative
Octadecabacter	negative
Heliobacillus	negative
Ignavigranum	positive
Mitsuokella	negative
Glaciecola	negative
Pelagibacter	negative
Clostridiaceae	positive
Selenomonas	negative
Gallicola	positive
Atopobium	positive
Lutiella	negative
Gluconobacter	negative
Parasutterella	negative
Tolumonas	negative
Gardnerella	positive
Chlamydophila	negative
Roseobacter	negative
Yonghaparkia	positive
Mogibacterium	positive
Symbiobacterium	negative
Azorhizophilus	negative
Tenacibaculum	negative
Saccharophagus	negative
Parascardovia	positive
Venenivibrio	negative
Nautilia	negative
Methylophilus	negative
Propionibacterium	positive
Agrobacterium	negative
Actinospica	positive
Sulfobacillus	positive
Ehrlichia	negative
Sorangium	negative
Chlamydia	negative
Alteromonadales	negative
Kaistia	negative
Sphingobium	negative
Uliginosibacterium	negative
Erwinia	negative
Eremococcus	positive
Coriobacteriaceae	positive
Enterobacteriaceae	negative
Coprobacillus	positive
Lentibacillus	positive
Winogradskyella	negative
Laceyella	positive
Alloiococcus	positive
Dactylosporangium	positive
Desulfomicrobium	negative
Labrenzia	negative
Psychrobacter	negative
Yokenella	negative
Maize	positive
Oceanospirillum	negative
Dickeya	negative
Zoogloea	negative
Ammonifex	positive
Tolypothrix	negative
Helcococcus	positive
Zymobacter	negative
Chitinophaga	negative
Limnobacter	negative
Archaea	archaea
Thiovulum	negative
Flexibacter	negative
Fischerella	negative
Chromobacterium	negative
Patulibacter	positive
Oleispira	negative
Kineococcus	positive
Leptothrix	negative
Nitratifractor	negative
Intrasporangium	positive
Nitrococcus	negative
Thermochromatium	negative
Campylobacter	negative
Rothia	positive
Curtobacterium	positive
Ruminococcaceae	positive
Onion	positive
Synechocystis	negative
Weeksella	negative
Thiorhodovibrio	negative
Zeaxanthinibacter	negative
Cyclobacterium	negative
Oceanospirillales	negative
Rubrobacter	positive
Maritimibacter	negative
Colwellia	negative
Vagococcus	positive
Aerococcus	positive
Bartonella	negative
Photorhabdus	negative
Pelotomaculum	positive
Geobacillus	positive
Halomonas	negative
Bradyrhizobiaceae	negative
Acidisoma	negative
Oscillatoriales	negative
Treponema	negative
Fastidiosipila	positive
Truepera	negative
Azoarcus	negative
Hydrogenobaculum	negative
Robiginitalea	negative
Actinocorallia	positive
Prochloron	negative
Aeromonas	negative
Ignatzschineria	negative
Actinobaculum	positive
Rathayibacter	positive
Thermobifida	positive
Facklamia	positive
Rickettsiella	negative
Microcystis	negative
Bosea	negative
Marinithermus	negative
Ideonella	negative
Citreicella	negative
Shewanella	negative
Albidovulum	negative
Dinoroseobacter	negative
Simkania	negative
Roseomonas	negative
BEV	negative
Clostridium	positive
Asanoa	positive
Saprospira	negative
Zobellia	negative
Planomicrobium	negative
Filifactor	positive
Acaryochloris	negative
Atrhrobacter	positive
Rikenella	negative
Blastobacter	negative
Sideroxydans	negative
Janthinobacterium	negative
Petrotoga	negative
Anaerotruncus	positive
Moraxella	negative
Quinella	negative
Enterobacter	negative
Persicivirga	negative
Rhodospirillales	negative
Butyrivibrio	negative
Pseudoramibacter	positive
Garciella	positive
beta	negative
Acidimicrobidae	positive
alpha	negative
Thioalkalivibrio	negative
Synechococcus	negative
Leptonema	negative
Faecalibacterium	negative
Haemophilus	negative
Phascolarctobacterium	negative
Sulfuricurvum	negative
Gillisia	negative
Acidothermus	positive
Desulfobacula	negative
Terriglobus	negative
Thermobacillus	positive
Muricauda	negative
Leifsonia	positive
Dorea	positive
Actinoplanes	positive
Cryptosporangium	positive
Methylobacterium	negative
Dechloromonas	negative
Thermus	negative
Holdemania	positive
Tepidibacter	positive
Simonsiella	negative
Jiangella	positive
Caloramator	positive
Methylosinus	negative
Ornithobacterium	negative
Ruminococcus	positive
Leminorella	negative
Microcoleus	negative
Arcobacter	negative
Kurthia	positive
Angulomicrobium	negative
Zymophilus	negative
Endoriftia	negative
Tatumella	negative
Xylophilus	negative
Kocuria	positive
Paenibacillus	positive
Algoriphagus	negative
Pelagibaca	negative
Chloroflexus	negative
Methylocella	negative
Ahrensia	negative
Halanaerobium	positive
Francisella	negative
Xenorhabdus	negative
Hydrogenobacter	negative
Ignavibacterium	negative
Nocardiopsis	positive
Zymomonas	negative
Acetohalobium	negative
Archangium	negative
Anaerococcus	positive
Ketogulonicigenium	negative
Ureaplasma	negative
Pseudoalteromonas	negative
Prevotella	negative
Iodobacter	negative
Papillibacter	positive
Nitrosomonas	negative
Thalassiobium	negative
Paraprevotella	negative
Gordonibacter	positive
Gaetbulibacter	negative
Rubrivivax	negative
Veillonella	negative
Lysinibacillus	positive
Aquaspirillum	negative
Mycobacterium	myco
Acetobacter	negative
Acidicaldus	negative
Arhodomonas	negative
Mycoplasma	negative
Ancylobacter	negative
Catenuloplanes	positive
Plesiocystis	negative
Actibacter	negative
Acetonema	negative
Verminephrobacter	negative
Oenococcus	positive
Congregibacter	negative
Leeuwenhoekiella	negative
Dietzia	positive
Zunongwangia	negative
Novosphingobium	negative
Undibacterium	negative
Thermotogales	negative
Endozoicomonas	negative
Singulisphaera	negative
Chloroherpeton	negative
Providencia	negative
Finegoldia	positive
Taylorella	negative
Staphylococcus	positive
Thiomonas	negative
Bifidobacterium	positive
Reinekea	negative
Solitalea	negative
Proteus	negative
Cupriavidus	negative
Pseudomonas	negative
Zhihengliuella	positive
Streptobacillus	negative
Anaerolinea	negative
Tropheryma	positive
Oxalobacteraceae	negative
Azospirillum	negative
Sodalis	negative
Carnimonas	negative
Scytonema	negative
Balnearium	negative
Bryobacter	negative
Hippea	negative
Streptosporangium	positive
Ectothiorhodospira	negative
Halorhodospira	negative
Anaplasma	negative
Stigmatella	negative
Orientia	negative
Acetobacterium	positive
Comamonadaceae	negative
Anaerobaculum	negative
Caldanaerovirga	negative
Dysgonomonas	negative
Flavobacteriaceae	negative
Rhodobacterales	negative
Nannocystis	negative
Methyloversatilis	negative
Desulfitobacterium	positive
Lautropia	negative
Ramlibacter	negative
Methylibium	negative
Dolosigranulum	positive
Crocosphaera	negative
Bacteroidales	negative
Carboxydibrachium	positive
Thermocrinis	negative
Balneatrix	negative
Shuttleworthia	positive
Oceanicaulis	negative
Xylanibacter	negative
Aequorivita	negative
Lawsonia	negative
Desulfococcus	negative
Carnobacterium	positive
Syntrophobotulus	negative
Cedecea	negative
Alkaliphilus	positive
Dechlorosoma	negative
Bacillus	positive
Williamsia	positive
Bibersteinia	negative
Helicobacter	negative
Xanthomonas	negative
Desulfosporosinus	positive
Kitasatospora	positive
Allokutzneria	positive
Methylobacter	negative
Cronobacter	negative
Turicella	positive
Pantoea	negative
Tatlockia	negative
Sphingopyxis	negative
Salegentibacter	negative
Arthrobacter	positive
Anaeroglobus	negative
Blattabacterium	negative
Syntrophobacter	negative
Azotobacter	negative
Desulfurivibrio	negative
Bradyrhizobium	negative
Catellatospora	positive
Sporolactobacillus	positive
Tsukamurella	positive
Prosthecochloris	negative
Nesterenkonia	positive
Marvinbryantia	positive
Oceanisphaera	negative
Burkholderia	negative
Halalkalibacillus	positive
Nitrobacter	negative
Anabaena	negative
Pasteurella	negative
Thermobispora	positive
Bellilinea	negative
Sulfurimonas	negative
Macrococcus	positive
Myroides	negative
Acidocella	negative
Raoultella	negative
Collinsella	positive
Ochrobactrum	negative
Anaerophaga	negative
Oceanithermus	negative
Gallibacterium	negative
primary	negative
Succinivibrionaceae	negative
Caminibacter	negative
Oceanobacillus	positive
blood	negative
Sphaerotilus	negative
Brevundimonas	negative
Serratia	negative
Beijerinckia	negative
Acaricomes	positive
Bermanella	negative
Kutzneria	positive
Angiococcus	negative
Frateuria	negative
Methylocystis	negative
Sphingobacterium	negative
Actinocatenispora	positive
Sarcina	positive
Loktanella	negative
Cellulomonas	positive
Legionella	negative
Rhodospirillum	negative
Microbacterium	positive
Cycloclasticus	negative
Aliivibrio	negative
Rheinheimera	negative
Silicibacter	negative
Labedella	positive
Brevibacterium	positive
Micavibrio	negative
Thermoanaerobacterium	positive
Kangiella	negative
Carboxydothermus	positive
Acidithiobacillus	negative
Planctomycetes	negative
Altererythrobacter	negative
Corynebacterium	positive
Nocardioides	positive
Desulfurobacterium	negative
Halonatronum	negative
Aurantimonas	negative
Emticicia	negative
Segniliparus	positive
Pseudonocardia	positive
Mobiluncus	positive
Ketogulonigenium	negative
Kluyvera	negative
Paucimonas	negative
Acidovorax	negative
Chlorobaculum	negative
Acetitomaculum	positive
Desulfovibrio	negative
Hydrogenivirga	negative
Neisseria	negative
Roseiflexus	negative
Jeotgalibacillus	variable
Niastella	negative
Prochlorococcus	negative
Acidimicrobium	positive
Rhodobacter	negative
Thiorhodospira	negative
Shigella	negative
Sanguibacter	positive
Flavobacteria	negative
Blautia	positive
Microvirga	negative
Listonella	negative
Yeosuana	negative
Actinotalea	positive
Balneola	negative
Ilyobacter	negative
Neptunomonas	negative
Desulfohalobium	negative
Neorickettsia	negative
Janibacter	positive
Aminobacterium	negative
Streptomyces	positive
Desulfotomaculum	positive
Chelativorans	negative
Bacteriovorax	negative
Pirellula	negative
Clostridiales	positive
Acidomonas	negative
Scardovia	positive
Verrucomicrobium	negative
Catenulispora	positive
Desulfobacca	negative
Nocardia	positive
Oceanicola	negative
Oscillibacter	negative
Kytococcus	positive
Burkholderiales	negative
Polymorphum	negative
Asaia	negative
Kosmotoga	negative
Actinopolyspora	positive
Stackebrandtia	positive
Clavibacter	positive
Blastomonas	positive
Yangia	negative
Bavariicoccus	positive
Centipeda	positive
Dyadobacter	negative
Citricoccus	positive
Megamonas	negative
Flavobacteriales	negative
Gluconacetobacter	negative
Syntrophorhabdus	negative
Lechevalieria	positive
Maricaulis	negative
Thiomicrospira	negative
Neptuniibacter	negative
Massilia	negative
Cyanobacteria	negative
Hafnia	negative
Micromonospora	positive
Acetomicrobium	negative
Fructobacillus	positive
Catonella	negative
Aquifex	negative
Flectobacillus	negative
Baumannia	negative
Planktothrix	negative
Nitrospina	negative
Rickettsia	negative
Methylotenera	negative
Virgibacillus	positive
Blastochloris	negative
Thalassospira	negative
Pectobacterium	negative
Acidisphaera	negative
Comamonas	negative
Beet	positive
Oribacterium	positive
Gordonia	positive
Pasteuria	positive
Oscillatoria	negative
Collimonas	negative
Fusobacterium	negative
Methylovorus	negative
Dehalococcoides	negative
Listeria	positive
Leptotrichia	negative
Aminomonas	negative
Thiorhodococcus	negative
Methylomonas	negative
Methylophilales	negative
Aster	positive
Variovorax	negative
Catenibacterium	positive
Cyanobium	negative
Dichelobacter	negative
Thiocapsa	negative
Salmonella	negative
Spiroplasma	positive
Polaromonas	negative
Diplococcus	positive
Ancalomicrobium	negative
Borrelia	negative
Aquiflexum	negative
Aquabacterium	negative
Coprococcus	positive
Acetoanaerobium	negative
Asticcacaulis	negative
Alicyclobacillus	positive
Rhodoferax	negative
Sinorhizobium	negative
Avibacterium	negative
Edwardsiella	negative
Acholeplasma	negative
Sulfurihydrogenibium	negative
Oxalobacter	negative
Parabacteroides	negative
Acidiphilium	negative
Anaerobiospirillum	negative
Fangia	negative
Hirschia	negative
Enterococcus	positive
Brachyspira	negative
Holophaga	negative
Marinovum	negative
Trichodesmium	negative
Brenneria	negative
Krokinobacter	negative
Trabulsiella	negative
gamma	negative
Astrosporangium	positive
Verrucomicrobia	negative
Turneriella	negative
Ralstonia	negative
Alcanivorax	negative
Acrocarpospora	positive
Dehalobacter	negative
Weissella	positive
Thermosediminibacter	negative
Bilophila	negative
Natranaerobius	positive
Eubacteriaceae	positive
Cyanobacterium	negative
Thermomicrobium	negative
Caldicellulosiruptor	positive
Lyngbya	negative
Melissococcus	positive
Nostoc	negative
Halobacillus	negative
Joostella	negative
Oceaniserpentilla	negative
Mannheimia	negative
Rhodobacteraceae	negative
Halothermothrix	negative
Aeromicrobium	positive
Leptospira	negative
Cyanothece	negative
Dehalobium	negative
Sneathia	negative
Saccharopolyspora	positive
Azomonas	negative
Frankia	positive
Acetobacteraceae	negative
Atopobacter	positive
Anaerorhabdus	negative
Marinitoga	negative
Lachnospiraceae	positive
Pediococcus	positive
Phormidium	negative
Hyphomicrobium	negative
Anaeromusa	negative
delta	negative
Acetothermus	negative
Moritella	negative
Xylanibacterium	positive
Thermosipho	negative
Parvularcula	negative
Fluviicola	negative
Syntrophus	negative
Caryophanon	positive
Anaerosinus	negative
Raphidiopsis	negative
Jannaschia	negative
Morganella	negative
Nitrosospira	negative
Zobellella	negative
Herpetosiphon	negative
Erysipelothrix	positive
Roseibium	negative
Tetragenococcus	positive
Roseovarius	negative
Thioploca	negative
Methylococcus	negative
Anoxybacillus	positive
Haliscomenobacter	negative
Paracoccus	negative
Polynucleobacter	negative
Brevibacillus	positive
Achromobacter	negative
Bizionia	negative
Granulicatella	positive
Meiothermus	negative
Citrobacter	negative
Brucella	negative
Pelodictyon	negative
Subdoligranulum	negative
Rhodomicrobium	negative
Alkalibacillus	positive
Maribacter	negative
Idiomarinaceae	negative
Desulfobacter	negative
Sulfitobacter	negative
Waddlia	negative
Ulvibacter	negative
Belliella	negative
Dokdonia	negative
Sporosarcina	positive
Sebaldella	negative
Marinobacterium	negative
Actinoalloteichus	positive
Alishewanella	negative
Desulfonispora	positive
Methylophaga	negative
Brevinema	negative
Owenweeksia	negative
Buttiauxella	negative
Actinosynnema	positive
Marichromatium	negative
Idiomarina	negative
Oligobacter	negative
Blastococcus	positive
Xylella	negative
Buchnera	negative
Bacteroidetes	negative
Polaribacter	negative
Citromicrobium	negative
actinobacterium	positive
Porphyromonas	negative
Grimontia	negative
Vibrio	negative
Epulopiscium	positive
Thermotoga	negative
Thermomonospora	positive
